games,summer,team,gold,silver,bronze,total,year
Athens 1896,1.0,United States of America,11,7,2,20,1896
Athens 1896,1.0,Greece,10,18,19,47,1896
Athens 1896,1.0,Germany,6,5,2,13,1896
Athens 1896,1.0,France,5,4,2,11,1896
Athens 1896,1.0,Great Britain,2,3,2,7,1896
Athens 1896,1.0,Hungary,2,1,3,6,1896
Athens 1896,1.0,Austria,2,1,2,5,1896
Athens 1896,1.0,Australia,2,0,0,2,1896
Athens 1896,1.0,Denmark,1,2,3,6,1896
Athens 1896,1.0,Switzerland,1,2,0,3,1896
Athens 1896,1.0,MIX,1,0,1,2,1896
London 1908,1.0,Great Britain,56,51,39,146,1908
London 1908,1.0,United States of America,23,12,12,47,1908
London 1908,1.0,Sweden,8,6,11,25,1908
London 1908,1.0,France,5,5,9,19,1908
London 1908,1.0,Germany,3,5,5,13,1908
London 1908,1.0,Hungary,3,4,2,9,1908
London 1908,1.0,Canada,3,3,10,16,1908
London 1908,1.0,Norway,2,3,3,8,1908
London 1908,1.0,Italy,2,2,0,4,1908
London 1908,1.0,Belgium,1,5,2,8,1908
London 1908,1.0,Australasia,1,2,2,5,1908
London 1908,1.0,Russian Federation,1,2,0,3,1908
London 1908,1.0,Finland,1,1,3,5,1908
London 1908,1.0,South Africa,1,1,0,2,1908
London 1908,1.0,Greece,0,3,1,4,1908
London 1908,1.0,Denmark,0,2,3,5,1908
London 1908,1.0,Netherlands,0,0,2,2,1908
London 1908,1.0,Bohemia,0,0,2,2,1908
London 1908,1.0,Austria,0,0,1,1,1908
Stockholm 1912,1.0,United States of America,26,19,19,64,1912
Stockholm 1912,1.0,Sweden,24,24,17,65,1912
Stockholm 1912,1.0,Great Britain,10,15,16,41,1912
Stockholm 1912,1.0,Finland,9,8,9,26,1912
Stockholm 1912,1.0,France,7,5,3,15,1912
Stockholm 1912,1.0,Germany,6,13,7,26,1912
Stockholm 1912,1.0,Italy,5,1,2,8,1912
Stockholm 1912,1.0,South Africa,4,2,0,6,1912
Stockholm 1912,1.0,Norway,4,1,5,10,1912
Stockholm 1912,1.0,Canada,3,2,3,8,1912
Stockholm 1912,1.0,Hungary,3,2,3,8,1912
Stockholm 1912,1.0,Australasia,2,2,3,7,1912
Stockholm 1912,1.0,Belgium,2,1,3,6,1912
Stockholm 1912,1.0,Denmark,1,6,5,12,1912
Stockholm 1912,1.0,Greece,1,0,1,2,1912
Stockholm 1912,1.0,Switzerland,1,0,0,1,1912
Stockholm 1912,1.0,Russian Federation,0,2,3,5,1912
Stockholm 1912,1.0,Austria,0,2,2,4,1912
Stockholm 1912,1.0,Netherlands,0,0,3,3,1912
Antwerp 1920,1.0,United States of America,41,27,27,95,1920
Antwerp 1920,1.0,Sweden,19,20,25,64,1920
Antwerp 1920,1.0,Belgium,16,12,14,42,1920
Antwerp 1920,1.0,Finland,15,10,9,34,1920
Antwerp 1920,1.0,Great Britain,14,16,13,43,1920
Antwerp 1920,1.0,Italy,14,6,5,25,1920
Antwerp 1920,1.0,Norway,13,10,9,32,1920
Antwerp 1920,1.0,France,9,20,13,42,1920
Antwerp 1920,1.0,Netherlands,4,2,5,11,1920
Antwerp 1920,1.0,Denmark,3,9,1,13,1920
Antwerp 1920,1.0,South Africa,3,4,3,10,1920
Antwerp 1920,1.0,Canada,3,3,3,9,1920
Antwerp 1920,1.0,Switzerland,2,2,7,11,1920
Antwerp 1920,1.0,Estonia,1,2,0,3,1920
Antwerp 1920,1.0,Brazil,1,1,1,3,1920
Antwerp 1920,1.0,Australia,0,2,1,3,1920
Antwerp 1920,1.0,Spain,0,2,0,2,1920
Antwerp 1920,1.0,Japan,0,2,0,2,1920
Antwerp 1920,1.0,Greece,0,1,0,1,1920
Antwerp 1920,1.0,Luxembourg,0,1,0,1,1920
Antwerp 1920,1.0,Czechoslovakia,0,0,2,2,1920
Antwerp 1920,1.0,New Zealand,0,0,1,1,1920
Paris 1924,1.0,United States of America,45,27,27,99,1924
Paris 1924,1.0,France,14,15,12,41,1924
Paris 1924,1.0,Finland,14,13,10,37,1924
Paris 1924,1.0,Great Britain,9,14,12,35,1924
Paris 1924,1.0,Italy,8,3,5,16,1924
Paris 1924,1.0,Switzerland,7,8,10,25,1924
Paris 1924,1.0,Norway,5,2,3,10,1924
Paris 1924,1.0,Sweden,4,13,12,29,1924
Paris 1924,1.0,Netherlands,4,1,6,11,1924
Paris 1924,1.0,Belgium,3,7,3,13,1924
Paris 1924,1.0,Australia,3,1,2,6,1924
Paris 1924,1.0,Denmark,2,6,3,11,1924
Paris 1924,1.0,Hungary,2,4,4,10,1924
Paris 1924,1.0,Yugoslavia,2,0,0,2,1924
Paris 1924,1.0,Czechoslovakia,1,4,5,10,1924
Paris 1924,1.0,Argentina,1,3,2,6,1924
Paris 1924,1.0,Estonia,1,1,4,6,1924
Paris 1924,1.0,South Africa,1,1,1,3,1924
Paris 1924,1.0,Luxembourg,1,1,0,2,1924
Paris 1924,1.0,Greece,1,0,0,1,1924
Paris 1924,1.0,Uruguay,1,0,0,1,1924
Paris 1924,1.0,Canada,0,3,1,4,1924
Paris 1924,1.0,Austria,0,3,1,4,1924
Paris 1924,1.0,Ireland,0,1,1,2,1924
Paris 1924,1.0,Poland,0,1,1,2,1924
Paris 1924,1.0,Japan,0,0,1,1,1924
Paris 1924,1.0,Haiti,0,0,1,1,1924
Paris 1924,1.0,Monaco,0,0,1,1,1924
Paris 1924,1.0,Portugal,0,0,1,1,1924
Paris 1924,1.0,Romania,0,0,1,1,1924
Paris 1924,1.0,New Zealand,0,0,1,1,1924
Chamonix 1924,0.0,Norway,4,7,6,17,1924
Chamonix 1924,0.0,Finland,4,4,3,11,1924
Chamonix 1924,0.0,Austria,2,1,0,3,1924
Chamonix 1924,0.0,Switzerland,2,0,1,3,1924
Chamonix 1924,0.0,United States of America,1,2,1,4,1924
Chamonix 1924,0.0,Great Britain,1,1,2,4,1924
Chamonix 1924,0.0,Sweden,1,1,0,2,1924
Chamonix 1924,0.0,Canada,1,0,0,1,1924
Chamonix 1924,0.0,MIX,1,0,0,1,1924
Chamonix 1924,0.0,France,0,0,3,3,1924
Chamonix 1924,0.0,Belgium,0,0,1,1,1924
Amsterdam 1928,1.0,United States of America,22,18,16,56,1928
Amsterdam 1928,1.0,Germany,11,9,19,39,1928
Amsterdam 1928,1.0,Netherlands,8,10,5,23,1928
Amsterdam 1928,1.0,Finland,8,8,9,25,1928
Amsterdam 1928,1.0,France,7,12,6,25,1928
Amsterdam 1928,1.0,Sweden,7,6,12,25,1928
Amsterdam 1928,1.0,Italy,7,6,7,20,1928
Amsterdam 1928,1.0,Switzerland,7,6,4,17,1928
Amsterdam 1928,1.0,Hungary,5,5,0,10,1928
Amsterdam 1928,1.0,Great Britain,4,11,7,22,1928
Amsterdam 1928,1.0,Canada,4,4,7,15,1928
Amsterdam 1928,1.0,Argentina,3,3,1,7,1928
Amsterdam 1928,1.0,Denmark,3,2,4,9,1928
Amsterdam 1928,1.0,Austria,3,0,1,4,1928
Amsterdam 1928,1.0,Czechoslovakia,2,5,2,9,1928
Amsterdam 1928,1.0,Japan,2,2,1,5,1928
Amsterdam 1928,1.0,Poland,2,1,4,7,1928
Amsterdam 1928,1.0,Estonia,2,1,2,5,1928
Amsterdam 1928,1.0,Egypt,2,1,1,4,1928
Amsterdam 1928,1.0,Norway,1,2,1,4,1928
Amsterdam 1928,1.0,Australia,1,2,1,4,1928
Amsterdam 1928,1.0,Yugoslavia,1,1,3,5,1928
Amsterdam 1928,1.0,South Africa,1,0,2,3,1928
Amsterdam 1928,1.0,Uruguay,1,0,0,1,1928
Amsterdam 1928,1.0,Spain,1,0,0,1,1928
Amsterdam 1928,1.0,Ireland,1,0,0,1,1928
Amsterdam 1928,1.0,Luxembourg,1,0,0,1,1928
Amsterdam 1928,1.0,India,1,0,0,1,1928
Amsterdam 1928,1.0,New Zealand,1,0,0,1,1928
Amsterdam 1928,1.0,Belgium,0,1,2,3,1928
Amsterdam 1928,1.0,Chile,0,1,0,1,1928
Amsterdam 1928,1.0,Haiti,0,1,0,1,1928
Amsterdam 1928,1.0,Philippines,0,0,1,1,1928
Amsterdam 1928,1.0,Portugal,0,0,1,1,1928
St. Moritz 1928,0.0,Norway,6,4,5,15,1928
St. Moritz 1928,0.0,United States of America,2,2,2,6,1928
St. Moritz 1928,0.0,Sweden,2,2,1,5,1928
St. Moritz 1928,0.0,Finland,2,1,1,4,1928
St. Moritz 1928,0.0,France,1,0,0,1,1928
St. Moritz 1928,0.0,Canada,1,0,0,1,1928
St. Moritz 1928,0.0,Austria,0,3,1,4,1928
St. Moritz 1928,0.0,Czechoslovakia,0,0,1,1,1928
St. Moritz 1928,0.0,Switzerland,0,0,1,1,1928
St. Moritz 1928,0.0,Germany,0,0,1,1,1928
St. Moritz 1928,0.0,Great Britain,0,0,1,1,1928
St. Moritz 1928,0.0,Belgium,0,0,1,1,1928
Lake Placid 1932,0.0,United States of America,6,4,2,12,1932
Lake Placid 1932,0.0,Norway,3,4,3,10,1932
Lake Placid 1932,0.0,Sweden,1,2,0,3,1932
Lake Placid 1932,0.0,Canada,1,1,5,7,1932
Lake Placid 1932,0.0,Finland,1,1,1,3,1932
Lake Placid 1932,0.0,Austria,1,1,0,2,1932
Lake Placid 1932,0.0,France,1,0,0,1,1932
Lake Placid 1932,0.0,Switzerland,0,1,0,1,1932
Lake Placid 1932,0.0,Germany,0,0,2,2,1932
Lake Placid 1932,0.0,Hungary,0,0,1,1,1932
Los Angeles 1932,1.0,United States of America,44,36,30,110,1932
Los Angeles 1932,1.0,Italy,12,12,12,36,1932
Los Angeles 1932,1.0,France,11,5,4,20,1932
Los Angeles 1932,1.0,Sweden,10,5,9,24,1932
Los Angeles 1932,1.0,Japan,7,7,4,18,1932
Los Angeles 1932,1.0,Hungary,6,5,5,16,1932
Los Angeles 1932,1.0,Germany,5,12,7,24,1932
Los Angeles 1932,1.0,Finland,5,8,12,25,1932
Los Angeles 1932,1.0,Great Britain,5,7,5,17,1932
Los Angeles 1932,1.0,Poland,3,2,4,9,1932
Los Angeles 1932,1.0,Australia,3,1,1,5,1932
Los Angeles 1932,1.0,Argentina,3,1,0,4,1932
Los Angeles 1932,1.0,Canada,2,5,9,16,1932
Los Angeles 1932,1.0,Netherlands,2,5,1,8,1932
Los Angeles 1932,1.0,South Africa,2,0,3,5,1932
Los Angeles 1932,1.0,Ireland,2,0,0,2,1932
Los Angeles 1932,1.0,Czechoslovakia,1,3,2,6,1932
Los Angeles 1932,1.0,Austria,1,1,3,5,1932
Los Angeles 1932,1.0,India,1,0,0,1,1932
Los Angeles 1932,1.0,Denmark,0,5,3,8,1932
Los Angeles 1932,1.0,Mexico,0,2,0,2,1932
Los Angeles 1932,1.0,Switzerland,0,1,0,1,1932
Los Angeles 1932,1.0,Latvia,0,1,0,1,1932
Los Angeles 1932,1.0,New Zealand,0,1,0,1,1932
Los Angeles 1932,1.0,Philippines,0,0,3,3,1932
Los Angeles 1932,1.0,Spain,0,0,1,1,1932
Los Angeles 1932,1.0,Belgium,0,0,1,1,1932
Los Angeles 1932,1.0,Uruguay,0,0,1,1,1932
Garmisch-Partenkirchen 1936,0.0,Norway,7,5,3,15,1936
Garmisch-Partenkirchen 1936,0.0,Germany,3,3,0,6,1936
Garmisch-Partenkirchen 1936,0.0,Sweden,2,2,3,7,1936
Garmisch-Partenkirchen 1936,0.0,Finland,1,2,3,6,1936
Garmisch-Partenkirchen 1936,0.0,Switzerland,1,2,0,3,1936
Garmisch-Partenkirchen 1936,0.0,Austria,1,1,2,4,1936
Garmisch-Partenkirchen 1936,0.0,Great Britain,1,1,1,3,1936
Garmisch-Partenkirchen 1936,0.0,United States of America,1,0,3,4,1936
Garmisch-Partenkirchen 1936,0.0,Canada,0,1,0,1,1936
Garmisch-Partenkirchen 1936,0.0,Hungary,0,0,1,1,1936
Garmisch-Partenkirchen 1936,0.0,France,0,0,1,1,1936
Berlin 1936,1.0,Germany,38,31,32,101,1936
Berlin 1936,1.0,United States of America,24,21,12,57,1936
Berlin 1936,1.0,Hungary,10,1,5,16,1936
Berlin 1936,1.0,Italy,9,13,5,27,1936
Berlin 1936,1.0,Finland,8,6,6,20,1936
Berlin 1936,1.0,France,7,6,6,19,1936
Berlin 1936,1.0,Sweden,6,5,10,21,1936
Berlin 1936,1.0,Japan,6,4,10,20,1936
Berlin 1936,1.0,Netherlands,6,4,7,17,1936
Berlin 1936,1.0,Austria,5,7,5,17,1936
Berlin 1936,1.0,Switzerland,4,9,5,18,1936
Berlin 1936,1.0,Great Britain,4,7,3,14,1936
Berlin 1936,1.0,Czechoslovakia,3,5,1,9,1936
Berlin 1936,1.0,Argentina,2,2,3,7,1936
Berlin 1936,1.0,Estonia,2,2,3,7,1936
Berlin 1936,1.0,Egypt,2,1,2,5,1936
Berlin 1936,1.0,Canada,1,3,5,9,1936
Berlin 1936,1.0,Norway,1,3,2,6,1936
Berlin 1936,1.0,Turkey,1,0,1,2,1936
Berlin 1936,1.0,New Zealand,1,0,0,1,1936
Berlin 1936,1.0,India,1,0,0,1,1936
Berlin 1936,1.0,Poland,0,4,5,9,1936
Berlin 1936,1.0,Denmark,0,2,3,5,1936
Berlin 1936,1.0,Latvia,0,1,1,2,1936
Berlin 1936,1.0,Romania,0,1,0,1,1936
Berlin 1936,1.0,South Africa,0,1,0,1,1936
Berlin 1936,1.0,Yugoslavia,0,1,0,1,1936
Berlin 1936,1.0,Belgium,0,0,3,3,1936
Berlin 1936,1.0,Mexico,0,0,3,3,1936
Berlin 1936,1.0,Portugal,0,0,1,1,1936
Berlin 1936,1.0,Philippines,0,0,1,1,1936
Berlin 1936,1.0,Australia,0,0,1,1,1936
St. Moritz 1948,0.0,Norway,4,3,3,10,1948
St. Moritz 1948,0.0,Sweden,4,3,3,10,1948
St. Moritz 1948,0.0,Switzerland,3,4,3,10,1948
St. Moritz 1948,0.0,United States of America,3,4,2,9,1948
St. Moritz 1948,0.0,France,2,1,2,5,1948
St. Moritz 1948,0.0,Canada,2,0,1,3,1948
St. Moritz 1948,0.0,Austria,1,3,4,8,1948
St. Moritz 1948,0.0,Finland,1,3,2,6,1948
St. Moritz 1948,0.0,Belgium,1,1,0,2,1948
St. Moritz 1948,0.0,Italy,1,0,0,1,1948
St. Moritz 1948,0.0,Czechoslovakia,0,1,0,1,1948
St. Moritz 1948,0.0,Hungary,0,1,0,1,1948
St. Moritz 1948,0.0,Great Britain,0,0,2,2,1948
London 1948,1.0,United States of America,38,27,19,84,1948
London 1948,1.0,Sweden,17,11,18,46,1948
London 1948,1.0,France,11,6,15,32,1948
London 1948,1.0,Finland,10,8,6,24,1948
London 1948,1.0,Hungary,10,5,13,28,1948
London 1948,1.0,Italy,9,12,10,31,1948
London 1948,1.0,Turkey,6,4,2,12,1948
London 1948,1.0,Czechoslovakia,6,2,3,11,1948
London 1948,1.0,Switzerland,5,12,6,23,1948
London 1948,1.0,Denmark,5,8,9,22,1948
London 1948,1.0,Netherlands,5,2,9,16,1948
London 1948,1.0,Great Britain,4,16,7,27,1948
London 1948,1.0,Argentina,3,3,1,7,1948
London 1948,1.0,Australia,2,6,5,13,1948
London 1948,1.0,Austria,2,2,4,8,1948
London 1948,1.0,Belgium,2,2,3,7,1948
London 1948,1.0,South Africa,2,2,2,6,1948
London 1948,1.0,Egypt,2,2,1,5,1948
London 1948,1.0,Mexico,2,1,2,5,1948
London 1948,1.0,Norway,1,3,3,7,1948
London 1948,1.0,Jamaica,1,2,0,3,1948
London 1948,1.0,Poland,1,0,1,2,1948
London 1948,1.0,Peru,1,0,0,1,1948
London 1948,1.0,India,1,0,0,1,1948
London 1948,1.0,Canada,0,2,2,4,1948
London 1948,1.0,Yugoslavia,0,2,0,2,1948
London 1948,1.0,Portugal,0,1,1,2,1948
London 1948,1.0,Uruguay,0,1,1,2,1948
London 1948,1.0,Trinidad and Tobago,0,1,0,1,1948
London 1948,1.0,Spain,0,1,0,1,1948
London 1948,1.0,Sri Lanka,0,1,0,1,1948
London 1948,1.0,Cuba,0,1,0,1,1948
London 1948,1.0,Republic of Korea,0,0,2,2,1948
London 1948,1.0,Panama,0,0,2,2,1948
London 1948,1.0,Brazil,0,0,1,1,1948
London 1948,1.0,Islamic Republic of Iran,0,0,1,1,1948
London 1948,1.0,Puerto Rico,0,0,1,1,1948
London 1948,1.0,Ireland,0,0,1,1,1948
Helsinki 1952,1.0,United States of America,40,19,17,76,1952
Helsinki 1952,1.0,Soviet Union,22,30,19,71,1952
Helsinki 1952,1.0,Hungary,16,10,16,42,1952
Helsinki 1952,1.0,Sweden,12,13,10,35,1952
Helsinki 1952,1.0,Italy,8,9,4,21,1952
Helsinki 1952,1.0,Czechoslovakia,7,3,3,13,1952
Helsinki 1952,1.0,France,6,6,6,18,1952
Helsinki 1952,1.0,Finland,6,3,13,22,1952
Helsinki 1952,1.0,Australia,6,2,3,11,1952
Helsinki 1952,1.0,Norway,3,2,0,5,1952
Helsinki 1952,1.0,Switzerland,2,6,6,14,1952
Helsinki 1952,1.0,South Africa,2,4,4,10,1952
Helsinki 1952,1.0,Jamaica,2,3,0,5,1952
Helsinki 1952,1.0,Belgium,2,2,0,4,1952
Helsinki 1952,1.0,Denmark,2,1,3,6,1952
Helsinki 1952,1.0,Turkey,2,0,1,3,1952
Helsinki 1952,1.0,Japan,1,6,2,9,1952
Helsinki 1952,1.0,Great Britain,1,2,8,11,1952
Helsinki 1952,1.0,Argentina,1,2,2,5,1952
Helsinki 1952,1.0,Poland,1,2,1,4,1952
Helsinki 1952,1.0,Yugoslavia,1,2,0,3,1952
Helsinki 1952,1.0,Canada,1,2,0,3,1952
Helsinki 1952,1.0,Romania,1,1,2,4,1952
Helsinki 1952,1.0,Brazil,1,0,2,3,1952
Helsinki 1952,1.0,New Zealand,1,0,2,3,1952
Helsinki 1952,1.0,India,1,0,1,2,1952
Helsinki 1952,1.0,Luxembourg,1,0,0,1,1952
Helsinki 1952,1.0,Germany,0,7,17,24,1952
Helsinki 1952,1.0,Netherlands,0,5,0,5,1952
Helsinki 1952,1.0,Islamic Republic of Iran,0,3,4,7,1952
Helsinki 1952,1.0,Chile,0,2,0,2,1952
Helsinki 1952,1.0,Austria,0,1,1,2,1952
Helsinki 1952,1.0,Lebanon,0,1,1,2,1952
Helsinki 1952,1.0,Spain,0,1,0,1,1952
Helsinki 1952,1.0,Mexico,0,1,0,1,1952
Helsinki 1952,1.0,Ireland,0,1,0,1,1952
Helsinki 1952,1.0,Republic of Korea,0,0,2,2,1952
Helsinki 1952,1.0,Trinidad and Tobago,0,0,2,2,1952
Helsinki 1952,1.0,Uruguay,0,0,2,2,1952
Helsinki 1952,1.0,Portugal,0,0,1,1,1952
Helsinki 1952,1.0,Egypt,0,0,1,1,1952
Helsinki 1952,1.0,Bulgaria,0,0,1,1,1952
Helsinki 1952,1.0,Venezuela,0,0,1,1,1952
Oslo 1952,0.0,Norway,7,3,6,16,1952
Oslo 1952,0.0,United States of America,4,6,1,11,1952
Oslo 1952,0.0,Finland,3,4,2,9,1952
Oslo 1952,0.0,Germany,3,2,2,7,1952
Oslo 1952,0.0,Austria,2,4,2,8,1952
Oslo 1952,0.0,Italy,1,0,1,2,1952
Oslo 1952,0.0,Canada,1,0,1,2,1952
Oslo 1952,0.0,Great Britain,1,0,0,1,1952
Oslo 1952,0.0,Netherlands,0,3,0,3,1952
Oslo 1952,0.0,Sweden,0,0,4,4,1952
Oslo 1952,0.0,Switzerland,0,0,2,2,1952
Oslo 1952,0.0,Hungary,0,0,1,1,1952
Oslo 1952,0.0,France,0,0,1,1,1952
Melbourne 1956,1.0,Soviet Union,37,29,32,98,1956
Melbourne 1956,1.0,United States of America,32,25,17,74,1956
Melbourne 1956,1.0,Australia,13,8,14,35,1956
Melbourne 1956,1.0,Hungary,9,10,7,26,1956
Melbourne 1956,1.0,Italy,8,6,8,22,1956
Melbourne 1956,1.0,Great Britain,5,7,9,21,1956
Melbourne 1956,1.0,Sweden,5,5,6,16,1956
Melbourne 1956,1.0,Romania,5,3,5,13,1956
Melbourne 1956,1.0,Germany,4,10,6,20,1956
Melbourne 1956,1.0,Japan,4,10,5,19,1956
Melbourne 1956,1.0,France,4,4,6,14,1956
Melbourne 1956,1.0,Turkey,3,2,2,7,1956
Melbourne 1956,1.0,Finland,3,1,11,15,1956
Melbourne 1956,1.0,Islamic Republic of Iran,2,2,1,5,1956
Melbourne 1956,1.0,Canada,2,1,2,5,1956
Melbourne 1956,1.0,New Zealand,2,0,0,2,1956
Melbourne 1956,1.0,Poland,1,4,4,9,1956
Melbourne 1956,1.0,Czechoslovakia,1,4,1,6,1956
Melbourne 1956,1.0,Bulgaria,1,3,1,5,1956
Melbourne 1956,1.0,Ireland,1,1,3,5,1956
Melbourne 1956,1.0,Denmark,1,1,1,3,1956
Melbourne 1956,1.0,Norway,1,0,2,3,1956
Melbourne 1956,1.0,Mexico,1,0,1,2,1956
Melbourne 1956,1.0,India,1,0,0,1,1956
Melbourne 1956,1.0,Brazil,1,0,0,1,1956
Melbourne 1956,1.0,Yugoslavia,0,3,0,3,1956
Melbourne 1956,1.0,Chile,0,2,2,4,1956
Melbourne 1956,1.0,Belgium,0,2,0,2,1956
Melbourne 1956,1.0,Republic of Korea,0,1,1,2,1956
Melbourne 1956,1.0,Argentina,0,1,1,2,1956
Melbourne 1956,1.0,Iceland,0,1,0,1,1956
Melbourne 1956,1.0,Pakistan,0,1,0,1,1956
Melbourne 1956,1.0,South Africa,0,0,4,4,1956
Melbourne 1956,1.0,Austria,0,0,2,2,1956
Melbourne 1956,1.0,Bahamas,0,0,1,1,1956
Melbourne 1956,1.0,Greece,0,0,1,1,1956
Melbourne 1956,1.0,Uruguay,0,0,1,1,1956
Squaw Valley 1960,0.0,Soviet Union,7,5,9,21,1960
Squaw Valley 1960,0.0,Germany,4,3,1,8,1960
Squaw Valley 1960,0.0,United States of America,3,4,3,10,1960
Squaw Valley 1960,0.0,Norway,3,3,0,6,1960
Squaw Valley 1960,0.0,Sweden,3,2,2,7,1960
Squaw Valley 1960,0.0,Finland,2,3,3,8,1960
Squaw Valley 1960,0.0,Canada,2,1,1,4,1960
Squaw Valley 1960,0.0,Switzerland,2,0,0,2,1960
Squaw Valley 1960,0.0,Austria,1,2,3,6,1960
Squaw Valley 1960,0.0,France,1,0,2,3,1960
Squaw Valley 1960,0.0,Netherlands,0,1,1,2,1960
Squaw Valley 1960,0.0,Poland,0,1,1,2,1960
Squaw Valley 1960,0.0,Czechoslovakia,0,1,0,1,1960
Squaw Valley 1960,0.0,Italy,0,0,1,1,1960
Rome 1960,1.0,Soviet Union,43,29,31,103,1960
Rome 1960,1.0,United States of America,34,21,16,71,1960
Rome 1960,1.0,Italy,13,10,13,36,1960
Rome 1960,1.0,Germany,12,19,11,42,1960
Rome 1960,1.0,Australia,8,8,6,22,1960
Rome 1960,1.0,Turkey,7,2,0,9,1960
Rome 1960,1.0,Hungary,6,8,7,21,1960
Rome 1960,1.0,Japan,4,7,7,18,1960
Rome 1960,1.0,Poland,4,6,11,21,1960
Rome 1960,1.0,Czechoslovakia,3,2,3,8,1960
Rome 1960,1.0,Romania,3,1,6,10,1960
Rome 1960,1.0,Great Britain,2,6,12,20,1960
Rome 1960,1.0,Denmark,2,3,1,6,1960
Rome 1960,1.0,New Zealand,2,0,1,3,1960
Rome 1960,1.0,Bulgaria,1,3,3,7,1960
Rome 1960,1.0,Sweden,1,2,3,6,1960
Rome 1960,1.0,Finland,1,1,3,5,1960
Rome 1960,1.0,Yugoslavia,1,1,0,2,1960
Rome 1960,1.0,Austria,1,1,0,2,1960
Rome 1960,1.0,Pakistan,1,0,1,2,1960
Rome 1960,1.0,Ethiopia,1,0,0,1,1960
Rome 1960,1.0,Greece,1,0,0,1,1960
Rome 1960,1.0,Norway,1,0,0,1,1960
Rome 1960,1.0,Switzerland,0,3,3,6,1960
Rome 1960,1.0,France,0,2,3,5,1960
Rome 1960,1.0,Belgium,0,2,2,4,1960
Rome 1960,1.0,Islamic Republic of Iran,0,1,3,4,1960
Rome 1960,1.0,South Africa,0,1,2,3,1960
Rome 1960,1.0,Netherlands,0,1,2,3,1960
Rome 1960,1.0,Argentina,0,1,1,2,1960
Rome 1960,1.0,United Arab Republic,0,1,1,2,1960
Rome 1960,1.0,Ghana,0,1,0,1,1960
Rome 1960,1.0,India,0,1,0,1,1960
Rome 1960,1.0,Morocco,0,1,0,1,1960
Rome 1960,1.0,Canada,0,1,0,1,1960
Rome 1960,1.0,Chinese Taipei,0,1,0,1,1960
Rome 1960,1.0,Portugal,0,1,0,1,1960
Rome 1960,1.0,Singapore,0,1,0,1,1960
Rome 1960,1.0,West Indies Federation,0,0,2,2,1960
Rome 1960,1.0,Brazil,0,0,2,2,1960
Rome 1960,1.0,Iraq,0,0,1,1,1960
Rome 1960,1.0,Venezuela,0,0,1,1,1960
Rome 1960,1.0,Spain,0,0,1,1,1960
Rome 1960,1.0,Mexico,0,0,1,1,1960
Innsbruck 1964,0.0,Soviet Union,11,8,6,25,1964
Innsbruck 1964,0.0,Austria,4,5,3,12,1964
Innsbruck 1964,0.0,Norway,3,6,6,15,1964
Innsbruck 1964,0.0,Finland,3,4,3,10,1964
Innsbruck 1964,0.0,France,3,4,0,7,1964
Innsbruck 1964,0.0,Germany,3,3,3,9,1964
Innsbruck 1964,0.0,Sweden,3,3,1,7,1964
Innsbruck 1964,0.0,United States of America,1,2,4,7,1964
Innsbruck 1964,0.0,Canada,1,1,1,3,1964
Innsbruck 1964,0.0,Netherlands,1,1,0,2,1964
Innsbruck 1964,0.0,Great Britain,1,0,0,1,1964
Innsbruck 1964,0.0,Italy,0,1,3,4,1964
Innsbruck 1964,0.0,Democratic People's Republic of Korea,0,1,0,1,1964
Innsbruck 1964,0.0,Czechoslovakia,0,0,1,1,1964
Tokyo 1964,1.0,United States of America,36,26,28,90,1964
Tokyo 1964,1.0,Soviet Union,30,31,35,96,1964
Tokyo 1964,1.0,Japan,16,5,8,29,1964
Tokyo 1964,1.0,Germany,10,22,18,50,1964
Tokyo 1964,1.0,Italy,10,10,7,27,1964
Tokyo 1964,1.0,Hungary,10,7,5,22,1964
Tokyo 1964,1.0,Poland,7,6,10,23,1964
Tokyo 1964,1.0,Australia,6,2,10,18,1964
Tokyo 1964,1.0,Czechoslovakia,5,6,3,14,1964
Tokyo 1964,1.0,Great Britain,4,12,2,18,1964
Tokyo 1964,1.0,Bulgaria,3,5,2,10,1964
Tokyo 1964,1.0,New Zealand,3,0,2,5,1964
Tokyo 1964,1.0,Finland,3,0,2,5,1964
Tokyo 1964,1.0,Romania,2,4,6,12,1964
Tokyo 1964,1.0,Netherlands,2,4,4,10,1964
Tokyo 1964,1.0,Turkey,2,3,1,6,1964
Tokyo 1964,1.0,Sweden,2,2,4,8,1964
Tokyo 1964,1.0,Denmark,2,1,3,6,1964
Tokyo 1964,1.0,Yugoslavia,2,1,2,5,1964
Tokyo 1964,1.0,Belgium,2,0,1,3,1964
Tokyo 1964,1.0,France,1,8,6,15,1964
Tokyo 1964,1.0,Switzerland,1,2,1,4,1964
Tokyo 1964,1.0,Canada,1,2,1,4,1964
Tokyo 1964,1.0,Ethiopia,1,0,0,1,1964
Tokyo 1964,1.0,India,1,0,0,1,1964
Tokyo 1964,1.0,Bahamas,1,0,0,1,1964
Tokyo 1964,1.0,Republic of Korea,0,2,1,3,1964
Tokyo 1964,1.0,Trinidad and Tobago,0,1,2,3,1964
Tokyo 1964,1.0,Tunisia,0,1,1,2,1964
Tokyo 1964,1.0,Philippines,0,1,0,1,1964
Tokyo 1964,1.0,Pakistan,0,1,0,1,1964
Tokyo 1964,1.0,Cuba,0,1,0,1,1964
Tokyo 1964,1.0,Argentina,0,1,0,1,1964
Tokyo 1964,1.0,Islamic Republic of Iran,0,0,2,2,1964
Tokyo 1964,1.0,Ireland,0,0,1,1,1964
Tokyo 1964,1.0,Kenya,0,0,1,1,1964
Tokyo 1964,1.0,Uruguay,0,0,1,1,1964
Tokyo 1964,1.0,Ghana,0,0,1,1,1964
Tokyo 1964,1.0,Nigeria,0,0,1,1,1964
Tokyo 1964,1.0,Brazil,0,0,1,1,1964
Tokyo 1964,1.0,Mexico,0,0,1,1,1964
Mexico City 1968,1.0,United States of America,45,28,34,107,1968
Mexico City 1968,1.0,Soviet Union,29,32,30,91,1968
Mexico City 1968,1.0,Japan,11,7,7,25,1968
Mexico City 1968,1.0,Hungary,10,10,12,32,1968
Mexico City 1968,1.0,German Democratic Republic (Germany),9,9,7,25,1968
Mexico City 1968,1.0,France,7,3,5,15,1968
Mexico City 1968,1.0,Czechoslovakia,7,2,4,13,1968
Mexico City 1968,1.0,Federal Republic of Germany,5,11,10,26,1968
Mexico City 1968,1.0,Australia,5,7,5,17,1968
Mexico City 1968,1.0,Great Britain,5,5,3,13,1968
Mexico City 1968,1.0,Poland,5,2,11,18,1968
Mexico City 1968,1.0,Romania,4,6,5,15,1968
Mexico City 1968,1.0,Italy,3,4,9,16,1968
Mexico City 1968,1.0,Kenya,3,4,2,9,1968
Mexico City 1968,1.0,Mexico,3,3,3,9,1968
Mexico City 1968,1.0,Yugoslavia,3,3,2,8,1968
Mexico City 1968,1.0,Netherlands,3,3,1,7,1968
Mexico City 1968,1.0,Bulgaria,2,4,3,9,1968
Mexico City 1968,1.0,Islamic Republic of Iran,2,1,2,5,1968
Mexico City 1968,1.0,Sweden,2,1,1,4,1968
Mexico City 1968,1.0,Turkey,2,0,0,2,1968
Mexico City 1968,1.0,Denmark,1,4,3,8,1968
Mexico City 1968,1.0,Canada,1,3,1,5,1968
Mexico City 1968,1.0,Finland,1,2,1,4,1968
Mexico City 1968,1.0,Norway,1,1,0,2,1968
Mexico City 1968,1.0,Ethiopia,1,1,0,2,1968
Mexico City 1968,1.0,New Zealand,1,0,2,3,1968
Mexico City 1968,1.0,Tunisia,1,0,1,2,1968
Mexico City 1968,1.0,Pakistan,1,0,0,1,1968
Mexico City 1968,1.0,Venezuela,1,0,0,1,1968
Mexico City 1968,1.0,Cuba,0,4,0,4,1968
Mexico City 1968,1.0,Austria,0,2,2,4,1968
Mexico City 1968,1.0,Switzerland,0,1,4,5,1968
Mexico City 1968,1.0,Mongolia,0,1,3,4,1968
Mexico City 1968,1.0,Brazil,0,1,2,3,1968
Mexico City 1968,1.0,Belgium,0,1,1,2,1968
Mexico City 1968,1.0,Uganda,0,1,1,2,1968
Mexico City 1968,1.0,Republic of Korea,0,1,1,2,1968
Mexico City 1968,1.0,Jamaica,0,1,0,1,1968
Mexico City 1968,1.0,Cameroon,0,1,0,1,1968
Mexico City 1968,1.0,Argentina,0,0,2,2,1968
Mexico City 1968,1.0,Chinese Taipei,0,0,1,1,1968
Mexico City 1968,1.0,Greece,0,0,1,1,1968
Mexico City 1968,1.0,India,0,0,1,1,1968
Grenoble 1968,0.0,Norway,6,6,2,14,1968
Grenoble 1968,0.0,Soviet Union,5,5,3,13,1968
Grenoble 1968,0.0,France,4,3,2,9,1968
Grenoble 1968,0.0,Italy,4,0,0,4,1968
Grenoble 1968,0.0,Austria,3,4,4,11,1968
Grenoble 1968,0.0,Netherlands,3,3,3,9,1968
Grenoble 1968,0.0,Sweden,3,2,3,8,1968
Grenoble 1968,0.0,Federal Republic of Germany,2,2,3,7,1968
Grenoble 1968,0.0,United States of America,1,5,1,7,1968
Grenoble 1968,0.0,German Democratic Republic (Germany),1,2,2,5,1968
Grenoble 1968,0.0,Finland,1,2,2,5,1968
Grenoble 1968,0.0,Czechoslovakia,1,2,1,4,1968
Grenoble 1968,0.0,Canada,1,1,1,3,1968
Grenoble 1968,0.0,Switzerland,0,2,4,6,1968
Grenoble 1968,0.0,Romania,0,0,1,1,1968
Sapporo 1972,0.0,Soviet Union,8,5,3,16,1972
Sapporo 1972,0.0,German Democratic Republic (Germany),4,3,7,14,1972
Sapporo 1972,0.0,Switzerland,4,3,3,10,1972
Sapporo 1972,0.0,Netherlands,4,3,2,9,1972
Sapporo 1972,0.0,United States of America,3,2,3,8,1972
Sapporo 1972,0.0,Federal Republic of Germany,3,1,1,5,1972
Sapporo 1972,0.0,Norway,2,5,5,12,1972
Sapporo 1972,0.0,Italy,2,2,1,5,1972
Sapporo 1972,0.0,Austria,1,2,2,5,1972
Sapporo 1972,0.0,Sweden,1,1,2,4,1972
Sapporo 1972,0.0,Japan,1,1,1,3,1972
Sapporo 1972,0.0,Czechoslovakia,1,0,2,3,1972
Sapporo 1972,0.0,Poland,1,0,0,1,1972
Sapporo 1972,0.0,Spain,1,0,0,1,1972
Sapporo 1972,0.0,Finland,0,4,1,5,1972
Sapporo 1972,0.0,France,0,1,2,3,1972
Sapporo 1972,0.0,Canada,0,1,0,1,1972
Munich 1972,1.0,Soviet Union,50,27,22,99,1972
Munich 1972,1.0,United States of America,33,31,30,94,1972
Munich 1972,1.0,German Democratic Republic (Germany),20,23,23,66,1972
Munich 1972,1.0,Federal Republic of Germany,13,11,16,40,1972
Munich 1972,1.0,Japan,13,8,8,29,1972
Munich 1972,1.0,Australia,8,7,2,17,1972
Munich 1972,1.0,Poland,7,5,9,21,1972
Munich 1972,1.0,Hungary,6,13,16,35,1972
Munich 1972,1.0,Bulgaria,6,10,5,21,1972
Munich 1972,1.0,Italy,5,3,10,18,1972
Munich 1972,1.0,Sweden,4,6,6,16,1972
Munich 1972,1.0,Great Britain,4,5,9,18,1972
Munich 1972,1.0,Romania,3,6,7,16,1972
Munich 1972,1.0,Finland,3,1,4,8,1972
Munich 1972,1.0,Cuba,3,1,4,8,1972
Munich 1972,1.0,Netherlands,3,1,1,5,1972
Munich 1972,1.0,France,2,4,7,13,1972
Munich 1972,1.0,Czechoslovakia,2,4,2,8,1972
Munich 1972,1.0,Kenya,2,3,4,9,1972
Munich 1972,1.0,Yugoslavia,2,1,2,5,1972
Munich 1972,1.0,Norway,2,1,1,4,1972
Munich 1972,1.0,Democratic People's Republic of Korea,1,1,3,5,1972
Munich 1972,1.0,New Zealand,1,1,1,3,1972
Munich 1972,1.0,Uganda,1,1,0,2,1972
Munich 1972,1.0,Denmark,1,0,0,1,1972
Munich 1972,1.0,Switzerland,0,3,0,3,1972
Munich 1972,1.0,Canada,0,2,3,5,1972
Munich 1972,1.0,Islamic Republic of Iran,0,2,1,3,1972
Munich 1972,1.0,Belgium,0,2,0,2,1972
Munich 1972,1.0,Greece,0,2,0,2,1972
Munich 1972,1.0,Colombia,0,1,2,3,1972
Munich 1972,1.0,Austria,0,1,2,3,1972
Munich 1972,1.0,Pakistan,0,1,0,1,1972
Munich 1972,1.0,Lebanon,0,1,0,1,1972
Munich 1972,1.0,Turkey,0,1,0,1,1972
Munich 1972,1.0,Republic of Korea,0,1,0,1,1972
Munich 1972,1.0,Mongolia,0,1,0,1,1972
Munich 1972,1.0,Argentina,0,1,0,1,1972
Munich 1972,1.0,Tunisia,0,1,0,1,1972
Munich 1972,1.0,Mexico,0,1,0,1,1972
Munich 1972,1.0,Brazil,0,0,2,2,1972
Munich 1972,1.0,Ethiopia,0,0,2,2,1972
Munich 1972,1.0,Spain,0,0,1,1,1972
Munich 1972,1.0,Ghana,0,0,1,1,1972
Munich 1972,1.0,Nigeria,0,0,1,1,1972
Munich 1972,1.0,India,0,0,1,1,1972
Munich 1972,1.0,Niger,0,0,1,1,1972
Munich 1972,1.0,Jamaica,0,0,1,1,1972
Montreal 1976,1.0,Soviet Union,49,41,35,125,1976
Montreal 1976,1.0,German Democratic Republic (Germany),40,25,25,90,1976
Montreal 1976,1.0,United States of America,34,35,25,94,1976
Montreal 1976,1.0,Federal Republic of Germany,10,12,17,39,1976
Montreal 1976,1.0,Japan,9,6,10,25,1976
Montreal 1976,1.0,Poland,7,6,13,26,1976
Montreal 1976,1.0,Bulgaria,6,9,7,22,1976
Montreal 1976,1.0,Cuba,6,4,3,13,1976
Montreal 1976,1.0,Romania,4,9,14,27,1976
Montreal 1976,1.0,Hungary,4,5,13,22,1976
Montreal 1976,1.0,Finland,4,2,0,6,1976
Montreal 1976,1.0,Sweden,4,1,0,5,1976
Montreal 1976,1.0,Great Britain,3,5,5,13,1976
Montreal 1976,1.0,Italy,2,7,4,13,1976
Montreal 1976,1.0,France,2,3,4,9,1976
Montreal 1976,1.0,Yugoslavia,2,3,3,8,1976
Montreal 1976,1.0,Czechoslovakia,2,2,4,8,1976
Montreal 1976,1.0,New Zealand,2,1,1,4,1976
Montreal 1976,1.0,Republic of Korea,1,1,4,6,1976
Montreal 1976,1.0,Switzerland,1,1,2,4,1976
Montreal 1976,1.0,Norway,1,1,0,2,1976
Montreal 1976,1.0,Democratic People's Republic of Korea,1,1,0,2,1976
Montreal 1976,1.0,Jamaica,1,1,0,2,1976
Montreal 1976,1.0,Denmark,1,0,2,3,1976
Montreal 1976,1.0,Mexico,1,0,1,2,1976
Montreal 1976,1.0,Trinidad and Tobago,1,0,0,1,1976
Montreal 1976,1.0,Canada,0,5,6,11,1976
Montreal 1976,1.0,Belgium,0,3,3,6,1976
Montreal 1976,1.0,Netherlands,0,2,3,5,1976
Montreal 1976,1.0,Portugal,0,2,0,2,1976
Montreal 1976,1.0,Spain,0,2,0,2,1976
Montreal 1976,1.0,Australia,0,1,4,5,1976
Montreal 1976,1.0,Islamic Republic of Iran,0,1,1,2,1976
Montreal 1976,1.0,Mongolia,0,1,0,1,1976
Montreal 1976,1.0,Venezuela,0,1,0,1,1976
Montreal 1976,1.0,Brazil,0,0,2,2,1976
Montreal 1976,1.0,Puerto Rico,0,0,1,1,1976
Montreal 1976,1.0,Bermuda,0,0,1,1,1976
Montreal 1976,1.0,Thailand,0,0,1,1,1976
Montreal 1976,1.0,Austria,0,0,1,1,1976
Montreal 1976,1.0,Pakistan,0,0,1,1,1976
Innsbruck 1976,0.0,Soviet Union,13,6,8,27,1976
Innsbruck 1976,0.0,German Democratic Republic (Germany),7,5,7,19,1976
Innsbruck 1976,0.0,United States of America,3,3,4,10,1976
Innsbruck 1976,0.0,Norway,3,3,1,7,1976
Innsbruck 1976,0.0,Federal Republic of Germany,2,5,3,10,1976
Innsbruck 1976,0.0,Finland,2,4,1,7,1976
Innsbruck 1976,0.0,Austria,2,2,2,6,1976
Innsbruck 1976,0.0,Switzerland,1,3,1,5,1976
Innsbruck 1976,0.0,Netherlands,1,2,3,6,1976
Innsbruck 1976,0.0,Italy,1,2,1,4,1976
Innsbruck 1976,0.0,Canada,1,1,1,3,1976
Innsbruck 1976,0.0,Great Britain,1,0,0,1,1976
Innsbruck 1976,0.0,Czechoslovakia,0,1,0,1,1976
Innsbruck 1976,0.0,Sweden,0,0,2,2,1976
Innsbruck 1976,0.0,Liechtenstein,0,0,2,2,1976
Innsbruck 1976,0.0,France,0,0,1,1,1976
Moscow 1980,1.0,Soviet Union,80,69,46,195,1980
Moscow 1980,1.0,German Democratic Republic (Germany),47,37,42,126,1980
Moscow 1980,1.0,Bulgaria,8,16,17,41,1980
Moscow 1980,1.0,Cuba,8,7,5,20,1980
Moscow 1980,1.0,Italy,8,3,4,15,1980
Moscow 1980,1.0,Hungary,7,10,15,32,1980
Moscow 1980,1.0,Romania,6,6,13,25,1980
Moscow 1980,1.0,France,6,5,3,14,1980
Moscow 1980,1.0,Great Britain,5,7,9,21,1980
Moscow 1980,1.0,Poland,3,14,15,32,1980
Moscow 1980,1.0,Sweden,3,3,6,12,1980
Moscow 1980,1.0,Finland,3,1,4,8,1980
Moscow 1980,1.0,Czechoslovakia,2,3,9,14,1980
Moscow 1980,1.0,Yugoslavia,2,3,4,9,1980
Moscow 1980,1.0,Australia,2,2,5,9,1980
Moscow 1980,1.0,Denmark,2,1,2,5,1980
Moscow 1980,1.0,Brazil,2,0,2,4,1980
Moscow 1980,1.0,Ethiopia,2,0,2,4,1980
Moscow 1980,1.0,Switzerland,2,0,0,2,1980
Moscow 1980,1.0,Spain,1,3,2,6,1980
Moscow 1980,1.0,Austria,1,2,1,4,1980
Moscow 1980,1.0,Greece,1,0,2,3,1980
Moscow 1980,1.0,Zimbabwe,1,0,0,1,1980
Moscow 1980,1.0,India,1,0,0,1,1980
Moscow 1980,1.0,Belgium,1,0,0,1,1980
Moscow 1980,1.0,Democratic People's Republic of Korea,0,3,2,5,1980
Moscow 1980,1.0,Mongolia,0,2,2,4,1980
Moscow 1980,1.0,United Republic of Tanzania,0,2,0,2,1980
Moscow 1980,1.0,Mexico,0,1,3,4,1980
Moscow 1980,1.0,Netherlands,0,1,2,3,1980
Moscow 1980,1.0,Ireland,0,1,1,2,1980
Moscow 1980,1.0,Uganda,0,1,0,1,1980
Moscow 1980,1.0,Venezuela,0,1,0,1,1980
Moscow 1980,1.0,Jamaica,0,0,3,3,1980
Moscow 1980,1.0,Guyana,0,0,1,1,1980
Moscow 1980,1.0,Lebanon,0,0,1,1,1980
Lake Placid 1980,0.0,Soviet Union,10,6,6,22,1980
Lake Placid 1980,0.0,German Democratic Republic (Germany),9,7,7,23,1980
Lake Placid 1980,0.0,United States of America,6,4,2,12,1980
Lake Placid 1980,0.0,Austria,3,2,2,7,1980
Lake Placid 1980,0.0,Sweden,3,0,1,4,1980
Lake Placid 1980,0.0,Liechtenstein,2,2,0,4,1980
Lake Placid 1980,0.0,Finland,1,5,3,9,1980
Lake Placid 1980,0.0,Norway,1,3,6,10,1980
Lake Placid 1980,0.0,Netherlands,1,2,1,4,1980
Lake Placid 1980,0.0,Switzerland,1,1,3,5,1980
Lake Placid 1980,0.0,Great Britain,1,0,0,1,1980
Lake Placid 1980,0.0,Federal Republic of Germany,0,2,3,5,1980
Lake Placid 1980,0.0,Italy,0,2,0,2,1980
Lake Placid 1980,0.0,Canada,0,1,1,2,1980
Lake Placid 1980,0.0,Hungary,0,1,0,1,1980
Lake Placid 1980,0.0,Japan,0,1,0,1,1980
Lake Placid 1980,0.0,France,0,0,1,1,1980
Lake Placid 1980,0.0,Czechoslovakia,0,0,1,1,1980
Lake Placid 1980,0.0,Bulgaria,0,0,1,1,1980
Sarajevo 1984,,German Democratic Republic (Germany),9,9,6,24,1984
Sarajevo 1984,,Soviet Union,6,10,9,25,1984
Sarajevo 1984,,United States of America,4,4,0,8,1984
Sarajevo 1984,,Finland,4,3,6,13,1984
Sarajevo 1984,,Sweden,4,2,2,8,1984
Sarajevo 1984,,Norway,3,2,4,9,1984
Sarajevo 1984,,Switzerland,2,2,1,5,1984
Sarajevo 1984,,Federal Republic of Germany,2,1,1,4,1984
Sarajevo 1984,,Canada,2,1,1,4,1984
Sarajevo 1984,,Italy,2,0,0,2,1984
Sarajevo 1984,,Great Britain,1,0,0,1,1984
Sarajevo 1984,,Czechoslovakia,0,2,4,6,1984
Sarajevo 1984,,France,0,1,2,3,1984
Sarajevo 1984,,Yugoslavia,0,1,0,1,1984
Sarajevo 1984,,Japan,0,1,0,1,1984
Sarajevo 1984,,Liechtenstein,0,0,2,2,1984
Sarajevo 1984,,Austria,0,0,1,1,1984
Los Angeles 1984,1.0,United States of America,83,61,30,174,1984
Los Angeles 1984,1.0,Romania,20,16,17,53,1984
Los Angeles 1984,1.0,Federal Republic of Germany,17,19,23,59,1984
Los Angeles 1984,1.0,People's Republic of China,15,8,9,32,1984
Los Angeles 1984,1.0,Italy,14,6,12,32,1984
Los Angeles 1984,1.0,Canada,10,18,16,44,1984
Los Angeles 1984,1.0,Japan,10,8,14,32,1984
Los Angeles 1984,1.0,New Zealand,8,1,2,11,1984
Los Angeles 1984,1.0,Yugoslavia,7,4,7,18,1984
Los Angeles 1984,1.0,Republic of Korea,6,6,7,19,1984
Los Angeles 1984,1.0,Great Britain,5,11,21,37,1984
Los Angeles 1984,1.0,France,5,7,16,28,1984
Los Angeles 1984,1.0,Netherlands,5,2,6,13,1984
Los Angeles 1984,1.0,Australia,4,8,12,24,1984
Los Angeles 1984,1.0,Finland,4,2,6,12,1984
Los Angeles 1984,1.0,Sweden,2,11,6,19,1984
Los Angeles 1984,1.0,Mexico,2,3,1,6,1984
Los Angeles 1984,1.0,Morocco,2,0,0,2,1984
Los Angeles 1984,1.0,Brazil,1,5,2,8,1984
Los Angeles 1984,1.0,Spain,1,2,2,5,1984
Los Angeles 1984,1.0,Belgium,1,1,2,4,1984
Los Angeles 1984,1.0,Austria,1,1,1,3,1984
Los Angeles 1984,1.0,Portugal,1,0,2,3,1984
Los Angeles 1984,1.0,Kenya,1,0,2,3,1984
Los Angeles 1984,1.0,Pakistan,1,0,0,1,1984
Los Angeles 1984,1.0,Switzerland,0,4,4,8,1984
Los Angeles 1984,1.0,Denmark,0,3,3,6,1984
Los Angeles 1984,1.0,Norway,0,1,2,3,1984
Los Angeles 1984,1.0,Jamaica,0,1,2,3,1984
Los Angeles 1984,1.0,Puerto Rico,0,1,1,2,1984
Los Angeles 1984,1.0,Greece,0,1,1,2,1984
Los Angeles 1984,1.0,Nigeria,0,1,1,2,1984
Los Angeles 1984,1.0,Egypt,0,1,0,1,1984
Los Angeles 1984,1.0,Thailand,0,1,0,1,1984
Los Angeles 1984,1.0,Colombia,0,1,0,1,1984
Los Angeles 1984,1.0,Peru,0,1,0,1,1984
Los Angeles 1984,1.0,Ireland,0,1,0,1,1984
Los Angeles 1984,1.0,Syrian Arab Republic,0,1,0,1,1984
Los Angeles 1984,1.0,Côte d'Ivoire,0,1,0,1,1984
Los Angeles 1984,1.0,Turkey,0,0,3,3,1984
Los Angeles 1984,1.0,Venezuela,0,0,3,3,1984
Los Angeles 1984,1.0,Algeria,0,0,2,2,1984
Los Angeles 1984,1.0,Iceland,0,0,1,1,1984
Los Angeles 1984,1.0,Chinese Taipei,0,0,1,1,1984
Los Angeles 1984,1.0,Dominican Republic,0,0,1,1,1984
Los Angeles 1984,1.0,Zambia,0,0,1,1,1984
Los Angeles 1984,1.0,Cameroon,0,0,1,1,1984
Seoul 1988,1.0,Soviet Union,55,31,46,132,1988
Seoul 1988,1.0,German Democratic Republic (Germany),37,35,30,102,1988
Seoul 1988,1.0,United States of America,36,31,27,94,1988
Seoul 1988,1.0,Republic of Korea,12,10,11,33,1988
Seoul 1988,1.0,Federal Republic of Germany,11,14,15,40,1988
Seoul 1988,1.0,Hungary,11,6,6,23,1988
Seoul 1988,1.0,Bulgaria,10,12,13,35,1988
Seoul 1988,1.0,Romania,7,11,6,24,1988
Seoul 1988,1.0,France,6,4,6,16,1988
Seoul 1988,1.0,Italy,6,4,4,14,1988
Seoul 1988,1.0,People's Republic of China,5,11,12,28,1988
Seoul 1988,1.0,Great Britain,5,10,9,24,1988
Seoul 1988,1.0,Kenya,5,2,2,9,1988
Seoul 1988,1.0,Japan,4,3,7,14,1988
Seoul 1988,1.0,Australia,3,6,5,14,1988
Seoul 1988,1.0,Yugoslavia,3,4,5,12,1988
Seoul 1988,1.0,Czechoslovakia,3,3,2,8,1988
Seoul 1988,1.0,New Zealand,3,2,8,13,1988
Seoul 1988,1.0,Canada,3,2,5,10,1988
Seoul 1988,1.0,Poland,2,5,9,16,1988
Seoul 1988,1.0,Norway,2,3,0,5,1988
Seoul 1988,1.0,Netherlands,2,2,5,9,1988
Seoul 1988,1.0,Denmark,2,1,1,4,1988
Seoul 1988,1.0,Brazil,1,2,3,6,1988
Seoul 1988,1.0,Spain,1,1,2,4,1988
Seoul 1988,1.0,Finland,1,1,2,4,1988
Seoul 1988,1.0,Turkey,1,1,0,2,1988
Seoul 1988,1.0,Morocco,1,0,2,3,1988
Seoul 1988,1.0,Suriname,1,0,0,1,1988
Seoul 1988,1.0,Portugal,1,0,0,1,1988
Seoul 1988,1.0,Austria,1,0,0,1,1988
Seoul 1988,1.0,Sweden,0,4,7,11,1988
Seoul 1988,1.0,Switzerland,0,2,2,4,1988
Seoul 1988,1.0,Jamaica,0,2,0,2,1988
Seoul 1988,1.0,Argentina,0,1,1,2,1988
Seoul 1988,1.0,Peru,0,1,0,1,1988
Seoul 1988,1.0,"Virgin Islands, US",0,1,0,1,1988
Seoul 1988,1.0,Senegal,0,1,0,1,1988
Seoul 1988,1.0,Indonesia,0,1,0,1,1988
Seoul 1988,1.0,Costa Rica,0,1,0,1,1988
Seoul 1988,1.0,Islamic Republic of Iran,0,1,0,1,1988
Seoul 1988,1.0,Netherlands Antilles,0,1,0,1,1988
Seoul 1988,1.0,Chile,0,1,0,1,1988
Seoul 1988,1.0,Mexico,0,0,2,2,1988
Seoul 1988,1.0,Belgium,0,0,2,2,1988
Seoul 1988,1.0,Mongolia,0,0,1,1,1988
Seoul 1988,1.0,Philippines,0,0,1,1,1988
Seoul 1988,1.0,Greece,0,0,1,1,1988
Seoul 1988,1.0,Thailand,0,0,1,1,1988
Seoul 1988,1.0,Colombia,0,0,1,1,1988
Seoul 1988,1.0,Djibouti,0,0,1,1,1988
Seoul 1988,1.0,Pakistan,0,0,1,1,1988
Calgary 1988,0.0,Soviet Union,11,9,9,29,1988
Calgary 1988,0.0,German Democratic Republic (Germany),9,10,6,25,1988
Calgary 1988,0.0,Switzerland,5,5,5,15,1988
Calgary 1988,0.0,Finland,4,1,2,7,1988
Calgary 1988,0.0,Sweden,4,0,2,6,1988
Calgary 1988,0.0,Austria,3,5,2,10,1988
Calgary 1988,0.0,Netherlands,3,2,2,7,1988
Calgary 1988,0.0,Federal Republic of Germany,2,4,2,8,1988
Calgary 1988,0.0,United States of America,2,1,3,6,1988
Calgary 1988,0.0,Italy,2,1,2,5,1988
Calgary 1988,0.0,France,1,0,1,2,1988
Calgary 1988,0.0,Norway,0,3,2,5,1988
Calgary 1988,0.0,Canada,0,2,3,5,1988
Calgary 1988,0.0,Yugoslavia,0,2,1,3,1988
Calgary 1988,0.0,Czechoslovakia,0,1,2,3,1988
Calgary 1988,0.0,Japan,0,0,1,1,1988
Calgary 1988,0.0,Liechtenstein,0,0,1,1,1988
Albertville 1992,0.0,Germany,10,10,6,26,1992
Albertville 1992,0.0,Unified Team,9,6,8,23,1992
Albertville 1992,0.0,Norway,9,6,5,20,1992
Albertville 1992,0.0,Austria,6,7,8,21,1992
Albertville 1992,0.0,United States of America,5,4,2,11,1992
Albertville 1992,0.0,Italy,4,6,4,14,1992
Albertville 1992,0.0,France,3,5,1,9,1992
Albertville 1992,0.0,Finland,3,1,3,7,1992
Albertville 1992,0.0,Canada,2,3,2,7,1992
Albertville 1992,0.0,Republic of Korea,2,1,1,4,1992
Albertville 1992,0.0,Japan,1,2,4,7,1992
Albertville 1992,0.0,Netherlands,1,1,2,4,1992
Albertville 1992,0.0,Sweden,1,0,3,4,1992
Albertville 1992,0.0,Switzerland,1,0,2,3,1992
Albertville 1992,0.0,People's Republic of China,0,3,0,3,1992
Albertville 1992,0.0,Luxembourg,0,2,0,2,1992
Albertville 1992,0.0,New Zealand,0,1,0,1,1992
Albertville 1992,0.0,Czechoslovakia,0,0,3,3,1992
Albertville 1992,0.0,Spain,0,0,1,1,1992
Albertville 1992,0.0,Democratic People's Republic of Korea,0,0,1,1,1992
Barcelona 1992,1.0,Unified Team,45,38,29,112,1992
Barcelona 1992,1.0,United States of America,37,34,37,108,1992
Barcelona 1992,1.0,Germany,33,21,28,82,1992
Barcelona 1992,1.0,People's Republic of China,16,22,16,54,1992
Barcelona 1992,1.0,Cuba,14,6,11,31,1992
Barcelona 1992,1.0,Spain,13,7,2,22,1992
Barcelona 1992,1.0,Republic of Korea,12,5,12,29,1992
Barcelona 1992,1.0,Hungary,11,12,7,30,1992
Barcelona 1992,1.0,France,8,5,16,29,1992
Barcelona 1992,1.0,Australia,7,9,11,27,1992
Barcelona 1992,1.0,Canada,7,4,7,18,1992
Barcelona 1992,1.0,Italy,6,5,8,19,1992
Barcelona 1992,1.0,Great Britain,5,3,12,20,1992
Barcelona 1992,1.0,Romania,4,6,8,18,1992
Barcelona 1992,1.0,Czechoslovakia,4,2,1,7,1992
Barcelona 1992,1.0,Democratic People's Republic of Korea,4,0,5,9,1992
Barcelona 1992,1.0,Japan,3,8,11,22,1992
Barcelona 1992,1.0,Bulgaria,3,7,6,16,1992
Barcelona 1992,1.0,Poland,3,6,10,19,1992
Barcelona 1992,1.0,Netherlands,2,6,7,15,1992
Barcelona 1992,1.0,Kenya,2,4,2,8,1992
Barcelona 1992,1.0,Norway,2,4,1,7,1992
Barcelona 1992,1.0,Turkey,2,2,2,6,1992
Barcelona 1992,1.0,Indonesia,2,2,1,5,1992
Barcelona 1992,1.0,Brazil,2,1,0,3,1992
Barcelona 1992,1.0,Greece,2,0,0,2,1992
Barcelona 1992,1.0,Sweden,1,7,4,12,1992
Barcelona 1992,1.0,New Zealand,1,4,5,10,1992
Barcelona 1992,1.0,Finland,1,2,2,5,1992
Barcelona 1992,1.0,Denmark,1,1,4,6,1992
Barcelona 1992,1.0,Morocco,1,1,1,3,1992
Barcelona 1992,1.0,Ireland,1,1,0,2,1992
Barcelona 1992,1.0,Ethiopia,1,0,2,3,1992
Barcelona 1992,1.0,Algeria,1,0,1,2,1992
Barcelona 1992,1.0,Estonia,1,0,1,2,1992
Barcelona 1992,1.0,Lithuania,1,0,1,2,1992
Barcelona 1992,1.0,Switzerland,1,0,0,1,1992
Barcelona 1992,1.0,Jamaica,0,3,1,4,1992
Barcelona 1992,1.0,Nigeria,0,3,1,4,1992
Barcelona 1992,1.0,Latvia,0,2,1,3,1992
Barcelona 1992,1.0,South Africa,0,2,0,2,1992
Barcelona 1992,1.0,Austria,0,2,0,2,1992
Barcelona 1992,1.0,Namibia,0,2,0,2,1992
Barcelona 1992,1.0,Belgium,0,1,2,3,1992
Barcelona 1992,1.0,Independent Olympic Athletes,0,1,2,3,1992
Barcelona 1992,1.0,Islamic Republic of Iran,0,1,2,3,1992
Barcelona 1992,1.0,Croatia,0,1,2,3,1992
Barcelona 1992,1.0,Israel,0,1,1,2,1992
Barcelona 1992,1.0,Chinese Taipei,0,1,0,1,1992
Barcelona 1992,1.0,Mexico,0,1,0,1,1992
Barcelona 1992,1.0,Peru,0,1,0,1,1992
Barcelona 1992,1.0,Mongolia,0,0,2,2,1992
Barcelona 1992,1.0,Slovenia,0,0,2,2,1992
Barcelona 1992,1.0,Bahamas,0,0,1,1,1992
Barcelona 1992,1.0,Argentina,0,0,1,1,1992
Barcelona 1992,1.0,Philippines,0,0,1,1,1992
Barcelona 1992,1.0,Qatar,0,0,1,1,1992
Barcelona 1992,1.0,Colombia,0,0,1,1,1992
Barcelona 1992,1.0,Ghana,0,0,1,1,1992
Barcelona 1992,1.0,Puerto Rico,0,0,1,1,1992
Barcelona 1992,1.0,Malaysia,0,0,1,1,1992
Barcelona 1992,1.0,Thailand,0,0,1,1,1992
Barcelona 1992,1.0,Suriname,0,0,1,1,1992
Barcelona 1992,1.0,Pakistan,0,0,1,1,1992
Lillehammer 1994,0.0,Russian Federation,11,8,4,23,1994
Lillehammer 1994,0.0,Norway,10,11,5,26,1994
Lillehammer 1994,0.0,Germany,9,7,8,24,1994
Lillehammer 1994,0.0,Italy,7,5,8,20,1994
Lillehammer 1994,0.0,United States of America,6,5,2,13,1994
Lillehammer 1994,0.0,Republic of Korea,4,1,1,6,1994
Lillehammer 1994,0.0,Canada,3,6,4,13,1994
Lillehammer 1994,0.0,Switzerland,3,4,2,9,1994
Lillehammer 1994,0.0,Austria,2,3,4,9,1994
Lillehammer 1994,0.0,Sweden,2,1,0,3,1994
Lillehammer 1994,0.0,Japan,1,2,2,5,1994
Lillehammer 1994,0.0,Kazakhstan,1,2,0,3,1994
Lillehammer 1994,0.0,Ukraine,1,0,1,2,1994
Lillehammer 1994,0.0,Uzbekistan,1,0,0,1,1994
Lillehammer 1994,0.0,Belarus,0,2,0,2,1994
Lillehammer 1994,0.0,Finland,0,1,5,6,1994
Lillehammer 1994,0.0,France,0,1,4,5,1994
Lillehammer 1994,0.0,Netherlands,0,1,3,4,1994
Lillehammer 1994,0.0,People's Republic of China,0,1,2,3,1994
Lillehammer 1994,0.0,Slovenia,0,0,3,3,1994
Lillehammer 1994,0.0,Great Britain,0,0,2,2,1994
Lillehammer 1994,0.0,Australia,0,0,1,1,1994
Atlanta 1996,1.0,United States of America,44,32,25,101,1996
Atlanta 1996,1.0,Russian Federation,26,21,16,63,1996
Atlanta 1996,1.0,Germany,20,18,27,65,1996
Atlanta 1996,1.0,People's Republic of China,16,22,12,50,1996
Atlanta 1996,1.0,France,15,7,15,37,1996
Atlanta 1996,1.0,Italy,13,10,12,35,1996
Atlanta 1996,1.0,Australia,9,9,23,41,1996
Atlanta 1996,1.0,Cuba,9,8,8,25,1996
Atlanta 1996,1.0,Ukraine,9,2,12,23,1996
Atlanta 1996,1.0,Republic of Korea,7,15,5,27,1996
Atlanta 1996,1.0,Poland,7,5,5,17,1996
Atlanta 1996,1.0,Hungary,7,4,10,21,1996
Atlanta 1996,1.0,Spain,5,6,6,17,1996
Atlanta 1996,1.0,Romania,4,7,9,20,1996
Atlanta 1996,1.0,Netherlands,4,5,10,19,1996
Atlanta 1996,1.0,Greece,4,4,0,8,1996
Atlanta 1996,1.0,Czech Republic,4,3,4,11,1996
Atlanta 1996,1.0,Switzerland,4,3,0,7,1996
Atlanta 1996,1.0,Denmark,4,1,1,6,1996
Atlanta 1996,1.0,Turkey,4,1,1,6,1996
Atlanta 1996,1.0,Canada,3,11,8,22,1996
Atlanta 1996,1.0,Bulgaria,3,7,5,15,1996
Atlanta 1996,1.0,Japan,3,6,5,14,1996
Atlanta 1996,1.0,Kazakhstan,3,4,4,11,1996
Atlanta 1996,1.0,Brazil,3,3,9,15,1996
Atlanta 1996,1.0,New Zealand,3,2,1,6,1996
Atlanta 1996,1.0,South Africa,3,1,1,5,1996
Atlanta 1996,1.0,Ireland,3,0,1,4,1996
Atlanta 1996,1.0,Sweden,2,4,2,8,1996
Atlanta 1996,1.0,Norway,2,2,3,7,1996
Atlanta 1996,1.0,Belgium,2,2,2,6,1996
Atlanta 1996,1.0,Nigeria,2,1,3,6,1996
Atlanta 1996,1.0,Democratic People's Republic of Korea,2,1,2,5,1996
Atlanta 1996,1.0,Algeria,2,0,1,3,1996
Atlanta 1996,1.0,Ethiopia,2,0,1,3,1996
Atlanta 1996,1.0,Great Britain,1,8,6,15,1996
Atlanta 1996,1.0,Belarus,1,6,8,15,1996
Atlanta 1996,1.0,Kenya,1,4,3,8,1996
Atlanta 1996,1.0,Jamaica,1,3,2,6,1996
Atlanta 1996,1.0,Finland,1,2,1,4,1996
Atlanta 1996,1.0,Serbia and Montenegro,1,1,2,4,1996
Atlanta 1996,1.0,Indonesia,1,1,2,4,1996
Atlanta 1996,1.0,Slovakia,1,1,1,3,1996
Atlanta 1996,1.0,Islamic Republic of Iran,1,1,1,3,1996
Atlanta 1996,1.0,Armenia,1,1,0,2,1996
Atlanta 1996,1.0,Croatia,1,1,0,2,1996
Atlanta 1996,1.0,Thailand,1,0,1,2,1996
Atlanta 1996,1.0,Portugal,1,0,1,2,1996
Atlanta 1996,1.0,Burundi,1,0,0,1,1996
Atlanta 1996,1.0,Syrian Arab Republic,1,0,0,1,1996
Atlanta 1996,1.0,Ecuador,1,0,0,1,1996
Atlanta 1996,1.0,"Hong Kong, China",1,0,0,1,1996
Atlanta 1996,1.0,Costa Rica,1,0,0,1,1996
Atlanta 1996,1.0,Argentina,0,2,1,3,1996
Atlanta 1996,1.0,Slovenia,0,2,0,2,1996
Atlanta 1996,1.0,Namibia,0,2,0,2,1996
Atlanta 1996,1.0,Austria,0,1,2,3,1996
Atlanta 1996,1.0,Malaysia,0,1,1,2,1996
Atlanta 1996,1.0,Republic of Moldova,0,1,1,2,1996
Atlanta 1996,1.0,Uzbekistan,0,1,1,2,1996
Atlanta 1996,1.0,Bahamas,0,1,0,1,1996
Atlanta 1996,1.0,Chinese Taipei,0,1,0,1,1996
Atlanta 1996,1.0,Zambia,0,1,0,1,1996
Atlanta 1996,1.0,Tonga,0,1,0,1,1996
Atlanta 1996,1.0,Latvia,0,1,0,1,1996
Atlanta 1996,1.0,Philippines,0,1,0,1,1996
Atlanta 1996,1.0,Azerbaijan,0,1,0,1,1996
Atlanta 1996,1.0,Georgia,0,0,2,2,1996
Atlanta 1996,1.0,Trinidad and Tobago,0,0,2,2,1996
Atlanta 1996,1.0,Morocco,0,0,2,2,1996
Atlanta 1996,1.0,Mexico,0,0,1,1,1996
Atlanta 1996,1.0,Mozambique,0,0,1,1,1996
Atlanta 1996,1.0,Mongolia,0,0,1,1,1996
Atlanta 1996,1.0,Tunisia,0,0,1,1,1996
Atlanta 1996,1.0,India,0,0,1,1,1996
Atlanta 1996,1.0,Uganda,0,0,1,1,1996
Atlanta 1996,1.0,Lithuania,0,0,1,1,1996
Atlanta 1996,1.0,Israel,0,0,1,1,1996
Atlanta 1996,1.0,Puerto Rico,0,0,1,1,1996
Nagano 1998,0.0,Germany,12,9,8,29,1998
Nagano 1998,0.0,Norway,10,10,5,25,1998
Nagano 1998,0.0,Russian Federation,9,6,3,18,1998
Nagano 1998,0.0,Canada,6,5,4,15,1998
Nagano 1998,0.0,United States of America,6,3,4,13,1998
Nagano 1998,0.0,Netherlands,5,4,2,11,1998
Nagano 1998,0.0,Japan,5,1,4,10,1998
Nagano 1998,0.0,Austria,3,5,9,17,1998
Nagano 1998,0.0,Republic of Korea,3,1,2,6,1998
Nagano 1998,0.0,Italy,2,6,2,10,1998
Nagano 1998,0.0,Finland,2,4,6,12,1998
Nagano 1998,0.0,Switzerland,2,2,3,7,1998
Nagano 1998,0.0,France,2,1,5,8,1998
Nagano 1998,0.0,Czech Republic,1,1,1,3,1998
Nagano 1998,0.0,Bulgaria,1,0,0,1,1998
Nagano 1998,0.0,People's Republic of China,0,6,2,8,1998
Nagano 1998,0.0,Sweden,0,2,1,3,1998
Nagano 1998,0.0,Denmark,0,1,0,1,1998
Nagano 1998,0.0,Ukraine,0,1,0,1,1998
Nagano 1998,0.0,Kazakhstan,0,0,2,2,1998
Nagano 1998,0.0,Belarus,0,0,2,2,1998
Nagano 1998,0.0,Australia,0,0,1,1,1998
Nagano 1998,0.0,Great Britain,0,0,1,1,1998
Nagano 1998,0.0,Belgium,0,0,1,1,1998
Sydney 2000,1.0,United States of America,37,24,32,93,2000
Sydney 2000,1.0,Russian Federation,32,28,29,89,2000
Sydney 2000,1.0,People's Republic of China,28,16,14,58,2000
Sydney 2000,1.0,Australia,16,25,17,58,2000
Sydney 2000,1.0,Germany,13,17,26,56,2000
Sydney 2000,1.0,France,13,14,11,38,2000
Sydney 2000,1.0,Italy,13,8,13,34,2000
Sydney 2000,1.0,Netherlands,12,9,4,25,2000
Sydney 2000,1.0,Cuba,11,11,7,29,2000
Sydney 2000,1.0,Great Britain,11,10,7,28,2000
Sydney 2000,1.0,Romania,11,6,9,26,2000
Sydney 2000,1.0,Republic of Korea,8,10,10,28,2000
Sydney 2000,1.0,Hungary,8,6,3,17,2000
Sydney 2000,1.0,Poland,6,5,3,14,2000
Sydney 2000,1.0,Japan,5,8,5,18,2000
Sydney 2000,1.0,Bulgaria,5,6,2,13,2000
Sydney 2000,1.0,Greece,4,6,3,13,2000
Sydney 2000,1.0,Sweden,4,5,3,12,2000
Sydney 2000,1.0,Norway,4,3,3,10,2000
Sydney 2000,1.0,Ethiopia,4,1,3,8,2000
Sydney 2000,1.0,Ukraine,3,10,10,23,2000
Sydney 2000,1.0,Kazakhstan,3,4,0,7,2000
Sydney 2000,1.0,Belarus,3,3,11,17,2000
Sydney 2000,1.0,Canada,3,3,8,14,2000
Sydney 2000,1.0,Spain,3,3,5,11,2000
Sydney 2000,1.0,Turkey,3,0,2,5,2000
Sydney 2000,1.0,Islamic Republic of Iran,3,0,1,4,2000
Sydney 2000,1.0,Czech Republic,2,3,3,8,2000
Sydney 2000,1.0,Kenya,2,3,2,7,2000
Sydney 2000,1.0,Denmark,2,3,1,6,2000
Sydney 2000,1.0,Finland,2,1,1,4,2000
Sydney 2000,1.0,Austria,2,1,0,3,2000
Sydney 2000,1.0,Lithuania,2,0,3,5,2000
Sydney 2000,1.0,Azerbaijan,2,0,1,3,2000
Sydney 2000,1.0,Bahamas,2,0,1,3,2000
Sydney 2000,1.0,Slovenia,2,0,0,2,2000
Sydney 2000,1.0,Switzerland,1,6,2,9,2000
Sydney 2000,1.0,Indonesia,1,3,2,6,2000
Sydney 2000,1.0,Slovakia,1,3,1,5,2000
Sydney 2000,1.0,Mexico,1,2,3,6,2000
Sydney 2000,1.0,Nigeria,1,2,0,3,2000
Sydney 2000,1.0,Algeria,1,1,3,5,2000
Sydney 2000,1.0,Uzbekistan,1,1,2,4,2000
Sydney 2000,1.0,Latvia,1,1,1,3,2000
Sydney 2000,1.0,Serbia and Montenegro,1,1,1,3,2000
Sydney 2000,1.0,New Zealand,1,0,3,4,2000
Sydney 2000,1.0,Estonia,1,0,2,3,2000
Sydney 2000,1.0,Thailand,1,0,2,3,2000
Sydney 2000,1.0,Croatia,1,0,1,2,2000
Sydney 2000,1.0,Colombia,1,0,0,1,2000
Sydney 2000,1.0,Cameroon,1,0,0,1,2000
Sydney 2000,1.0,Mozambique,1,0,0,1,2000
Sydney 2000,1.0,Brazil,0,6,6,12,2000
Sydney 2000,1.0,Jamaica,0,6,3,9,2000
Sydney 2000,1.0,Belgium,0,2,3,5,2000
Sydney 2000,1.0,South Africa,0,2,3,5,2000
Sydney 2000,1.0,Argentina,0,2,2,4,2000
Sydney 2000,1.0,Chinese Taipei,0,1,4,5,2000
Sydney 2000,1.0,Morocco,0,1,4,5,2000
Sydney 2000,1.0,Democratic People's Republic of Korea,0,1,3,4,2000
Sydney 2000,1.0,Saudi Arabia,0,1,1,2,2000
Sydney 2000,1.0,Republic of Moldova,0,1,1,2,2000
Sydney 2000,1.0,Trinidad and Tobago,0,1,1,2,2000
Sydney 2000,1.0,Ireland,0,1,0,1,2000
Sydney 2000,1.0,Sri Lanka,0,1,0,1,2000
Sydney 2000,1.0,Uruguay,0,1,0,1,2000
Sydney 2000,1.0,Vietnam,0,1,0,1,2000
Sydney 2000,1.0,Georgia,0,0,6,6,2000
Sydney 2000,1.0,Portugal,0,0,2,2,2000
Sydney 2000,1.0,Costa Rica,0,0,2,2,2000
Sydney 2000,1.0,Chile,0,0,1,1,2000
Sydney 2000,1.0,Iceland,0,0,1,1,2000
Sydney 2000,1.0,India,0,0,1,1,2000
Sydney 2000,1.0,Israel,0,0,1,1,2000
Sydney 2000,1.0,Kuwait,0,0,1,1,2000
Sydney 2000,1.0,Armenia,0,0,1,1,2000
Sydney 2000,1.0,Barbados,0,0,1,1,2000
Sydney 2000,1.0,Kyrgyzstan,0,0,1,1,2000
Sydney 2000,1.0,Qatar,0,0,1,1,2000
Sydney 2000,1.0,North Macedonia,0,0,1,1,2000
Salt Lake City 2002,0.0,Norway,13,5,7,25,2002
Salt Lake City 2002,0.0,Germany,12,16,8,36,2002
Salt Lake City 2002,0.0,United States of America,10,13,11,34,2002
Salt Lake City 2002,0.0,Canada,7,3,7,17,2002
Salt Lake City 2002,0.0,Russian Federation,5,4,4,13,2002
Salt Lake City 2002,0.0,France,4,5,2,11,2002
Salt Lake City 2002,0.0,Italy,4,4,5,13,2002
Salt Lake City 2002,0.0,Finland,4,2,1,7,2002
Salt Lake City 2002,0.0,Netherlands,3,5,0,8,2002
Salt Lake City 2002,0.0,Austria,3,4,10,17,2002
Salt Lake City 2002,0.0,Switzerland,3,2,6,11,2002
Salt Lake City 2002,0.0,Croatia,3,1,0,4,2002
Salt Lake City 2002,0.0,People's Republic of China,2,2,4,8,2002
Salt Lake City 2002,0.0,Republic of Korea,2,2,0,4,2002
Salt Lake City 2002,0.0,Australia,2,0,0,2,2002
Salt Lake City 2002,0.0,Czech Republic,1,2,0,3,2002
Salt Lake City 2002,0.0,Estonia,1,1,1,3,2002
Salt Lake City 2002,0.0,Great Britain,1,0,1,2,2002
Salt Lake City 2002,0.0,Sweden,0,2,5,7,2002
Salt Lake City 2002,0.0,Bulgaria,0,1,2,3,2002
Salt Lake City 2002,0.0,Japan,0,1,1,2,2002
Salt Lake City 2002,0.0,Poland,0,1,1,2,2002
Salt Lake City 2002,0.0,Belarus,0,0,1,1,2002
Salt Lake City 2002,0.0,Slovenia,0,0,1,1,2002
Athens 2004,1.0,United States of America,36,39,26,101,2004
Athens 2004,1.0,People's Republic of China,32,17,14,63,2004
Athens 2004,1.0,Russian Federation,28,26,36,90,2004
Athens 2004,1.0,Australia,17,16,17,50,2004
Athens 2004,1.0,Japan,16,9,12,37,2004
Athens 2004,1.0,Germany,13,16,20,49,2004
Athens 2004,1.0,France,11,9,13,33,2004
Athens 2004,1.0,Italy,10,11,11,32,2004
Athens 2004,1.0,Republic of Korea,9,12,9,30,2004
Athens 2004,1.0,Great Britain,9,9,12,30,2004
Athens 2004,1.0,Cuba,9,7,11,27,2004
Athens 2004,1.0,Hungary,8,6,3,17,2004
Athens 2004,1.0,Ukraine,8,5,9,22,2004
Athens 2004,1.0,Romania,8,5,6,19,2004
Athens 2004,1.0,Greece,6,6,4,16,2004
Athens 2004,1.0,Brazil,5,2,3,10,2004
Athens 2004,1.0,Norway,5,0,1,6,2004
Athens 2004,1.0,Netherlands,4,9,9,22,2004
Athens 2004,1.0,Sweden,4,2,1,7,2004
Athens 2004,1.0,Spain,3,11,6,20,2004
Athens 2004,1.0,Canada,3,6,3,12,2004
Athens 2004,1.0,Turkey,3,3,4,10,2004
Athens 2004,1.0,Poland,3,2,5,10,2004
Athens 2004,1.0,New Zealand,3,2,0,5,2004
Athens 2004,1.0,Thailand,3,1,4,8,2004
Athens 2004,1.0,Belarus,2,5,6,13,2004
Athens 2004,1.0,Austria,2,4,1,7,2004
Athens 2004,1.0,Ethiopia,2,3,2,7,2004
Athens 2004,1.0,Islamic Republic of Iran,2,2,2,6,2004
Athens 2004,1.0,Slovakia,2,2,2,6,2004
Athens 2004,1.0,Chinese Taipei,2,2,1,5,2004
Athens 2004,1.0,Georgia,2,2,0,4,2004
Athens 2004,1.0,Bulgaria,2,1,9,12,2004
Athens 2004,1.0,Denmark,2,1,5,8,2004
Athens 2004,1.0,Jamaica,2,1,2,5,2004
Athens 2004,1.0,Uzbekistan,2,1,2,5,2004
Athens 2004,1.0,Morocco,2,1,0,3,2004
Athens 2004,1.0,Argentina,2,0,4,6,2004
Athens 2004,1.0,Chile,2,0,1,3,2004
Athens 2004,1.0,Kazakhstan,1,4,3,8,2004
Athens 2004,1.0,Kenya,1,4,2,7,2004
Athens 2004,1.0,Czech Republic,1,3,5,9,2004
Athens 2004,1.0,South Africa,1,3,2,6,2004
Athens 2004,1.0,Croatia,1,2,2,5,2004
Athens 2004,1.0,Lithuania,1,2,0,3,2004
Athens 2004,1.0,Switzerland,1,1,3,5,2004
Athens 2004,1.0,Egypt,1,1,3,5,2004
Athens 2004,1.0,Indonesia,1,1,2,4,2004
Athens 2004,1.0,Zimbabwe,1,1,1,3,2004
Athens 2004,1.0,Azerbaijan,1,0,4,5,2004
Athens 2004,1.0,Belgium,1,0,2,3,2004
Athens 2004,1.0,Israel,1,0,1,2,2004
Athens 2004,1.0,Bahamas,1,0,1,2,2004
Athens 2004,1.0,Cameroon,1,0,0,1,2004
Athens 2004,1.0,Dominican Republic,1,0,0,1,2004
Athens 2004,1.0,United Arab Emirates,1,0,0,1,2004
Athens 2004,1.0,Democratic People's Republic of Korea,0,4,1,5,2004
Athens 2004,1.0,Latvia,0,4,0,4,2004
Athens 2004,1.0,Mexico,0,3,1,4,2004
Athens 2004,1.0,Portugal,0,2,1,3,2004
Athens 2004,1.0,Finland,0,2,0,2,2004
Athens 2004,1.0,Serbia and Montenegro,0,2,0,2,2004
Athens 2004,1.0,Slovenia,0,1,3,4,2004
Athens 2004,1.0,Estonia,0,1,2,3,2004
Athens 2004,1.0,India,0,1,0,1,2004
Athens 2004,1.0,"Hong Kong, China",0,1,0,1,2004
Athens 2004,1.0,Paraguay,0,1,0,1,2004
Athens 2004,1.0,Colombia,0,0,2,2,2004
Athens 2004,1.0,Venezuela,0,0,2,2,2004
Athens 2004,1.0,Nigeria,0,0,2,2,2004
Athens 2004,1.0,Eritrea,0,0,1,1,2004
Athens 2004,1.0,Mongolia,0,0,1,1,2004
Athens 2004,1.0,Trinidad and Tobago,0,0,1,1,2004
Athens 2004,1.0,Syrian Arab Republic,0,0,1,1,2004
Beijing 2008,1.0,People's Republic of China,48,22,30,100,2008
Beijing 2008,1.0,United States of America,36,39,37,112,2008
Beijing 2008,1.0,Russian Federation,24,13,23,60,2008
Beijing 2008,1.0,Great Britain,19,13,19,51,2008
Beijing 2008,1.0,Germany,16,11,14,41,2008
Beijing 2008,1.0,Australia,14,15,17,46,2008
Beijing 2008,1.0,Republic of Korea,13,11,8,32,2008
Beijing 2008,1.0,Japan,9,8,8,25,2008
Beijing 2008,1.0,Italy,8,9,10,27,2008
Beijing 2008,1.0,France,7,16,20,43,2008
Beijing 2008,1.0,Netherlands,7,5,4,16,2008
Beijing 2008,1.0,Ukraine,7,4,11,22,2008
Beijing 2008,1.0,Kenya,6,4,6,16,2008
Beijing 2008,1.0,Spain,5,11,3,19,2008
Beijing 2008,1.0,Jamaica,5,4,1,10,2008
Beijing 2008,1.0,Poland,4,5,2,11,2008
Beijing 2008,1.0,Ethiopia,4,2,1,7,2008
Beijing 2008,1.0,Romania,4,1,4,9,2008
Beijing 2008,1.0,Cuba,3,10,17,30,2008
Beijing 2008,1.0,Canada,3,9,8,20,2008
Beijing 2008,1.0,Hungary,3,5,2,10,2008
Beijing 2008,1.0,Norway,3,5,1,9,2008
Beijing 2008,1.0,Brazil,3,4,10,17,2008
Beijing 2008,1.0,Belarus,3,4,7,14,2008
Beijing 2008,1.0,Czech Republic,3,3,1,7,2008
Beijing 2008,1.0,Slovakia,3,3,0,6,2008
Beijing 2008,1.0,New Zealand,3,2,4,9,2008
Beijing 2008,1.0,Georgia,3,2,2,7,2008
Beijing 2008,1.0,Kazakhstan,2,3,4,9,2008
Beijing 2008,1.0,Denmark,2,2,3,7,2008
Beijing 2008,1.0,Thailand,2,2,2,6,2008
Beijing 2008,1.0,Democratic People's Republic of Korea,2,2,2,6,2008
Beijing 2008,1.0,Mongolia,2,2,0,4,2008
Beijing 2008,1.0,Switzerland,2,1,4,7,2008
Beijing 2008,1.0,Argentina,2,0,4,6,2008
Beijing 2008,1.0,Mexico,2,0,2,4,2008
Beijing 2008,1.0,Belgium,2,0,0,2,2008
Beijing 2008,1.0,Zimbabwe,1,3,0,4,2008
Beijing 2008,1.0,Slovenia,1,2,2,5,2008
Beijing 2008,1.0,Azerbaijan,1,1,4,6,2008
Beijing 2008,1.0,Indonesia,1,1,4,6,2008
Beijing 2008,1.0,Turkey,1,1,3,5,2008
Beijing 2008,1.0,Bulgaria,1,1,3,5,2008
Beijing 2008,1.0,Finland,1,1,2,4,2008
Beijing 2008,1.0,Chinese Taipei,1,1,2,4,2008
Beijing 2008,1.0,Latvia,1,1,1,3,2008
Beijing 2008,1.0,Estonia,1,1,0,2,2008
Beijing 2008,1.0,Portugal,1,1,0,2,2008
Beijing 2008,1.0,Dominican Republic,1,1,0,2,2008
Beijing 2008,1.0,Trinidad and Tobago,1,1,0,2,2008
Beijing 2008,1.0,India,1,0,2,3,2008
Beijing 2008,1.0,Islamic Republic of Iran,1,0,1,2,2008
Beijing 2008,1.0,Cameroon,1,0,0,1,2008
Beijing 2008,1.0,Tunisia,1,0,0,1,2008
Beijing 2008,1.0,Panama,1,0,0,1,2008
Beijing 2008,1.0,Sweden,0,4,1,5,2008
Beijing 2008,1.0,Lithuania,0,3,2,5,2008
Beijing 2008,1.0,Nigeria,0,2,3,5,2008
Beijing 2008,1.0,Croatia,0,2,3,5,2008
Beijing 2008,1.0,Colombia,0,2,1,3,2008
Beijing 2008,1.0,Greece,0,2,1,3,2008
Beijing 2008,1.0,Armenia,0,1,4,5,2008
Beijing 2008,1.0,Uzbekistan,0,1,3,4,2008
Beijing 2008,1.0,Austria,0,1,2,3,2008
Beijing 2008,1.0,Ireland,0,1,2,3,2008
Beijing 2008,1.0,Serbia,0,1,2,3,2008
Beijing 2008,1.0,Kyrgyzstan,0,1,2,3,2008
Beijing 2008,1.0,Algeria,0,1,1,2,2008
Beijing 2008,1.0,Bahamas,0,1,1,2,2008
Beijing 2008,1.0,Morocco,0,1,1,2,2008
Beijing 2008,1.0,Tajikistan,0,1,1,2,2008
Beijing 2008,1.0,Chile,0,1,0,1,2008
Beijing 2008,1.0,Malaysia,0,1,0,1,2008
Beijing 2008,1.0,Sudan,0,1,0,1,2008
Beijing 2008,1.0,Ecuador,0,1,0,1,2008
Beijing 2008,1.0,Vietnam,0,1,0,1,2008
Beijing 2008,1.0,Iceland,0,1,0,1,2008
Beijing 2008,1.0,Singapore,0,1,0,1,2008
Beijing 2008,1.0,South Africa,0,1,0,1,2008
Beijing 2008,1.0,Samoa,0,1,0,1,2008
Beijing 2008,1.0,Egypt,0,0,2,2,2008
Beijing 2008,1.0,Republic of Moldova,0,0,1,1,2008
Beijing 2008,1.0,Israel,0,0,1,1,2008
Beijing 2008,1.0,Mauritius,0,0,1,1,2008
Beijing 2008,1.0,Afghanistan,0,0,1,1,2008
Beijing 2008,1.0,Venezuela,0,0,1,1,2008
Beijing 2008,1.0,Togo,0,0,1,1,2008
Vancouver 2010,0.0,Canada,14,7,5,26,2010
Vancouver 2010,0.0,Germany,10,13,7,30,2010
Vancouver 2010,0.0,United States of America,9,15,13,37,2010
Vancouver 2010,0.0,Norway,9,8,6,23,2010
Vancouver 2010,0.0,Republic of Korea,6,6,2,14,2010
Vancouver 2010,0.0,Switzerland,6,0,3,9,2010
Vancouver 2010,0.0,People's Republic of China,5,2,4,11,2010
Vancouver 2010,0.0,Sweden,5,2,4,11,2010
Vancouver 2010,0.0,Austria,4,6,6,16,2010
Vancouver 2010,0.0,Netherlands,4,1,3,8,2010
Vancouver 2010,0.0,Russian Federation,3,5,7,15,2010
Vancouver 2010,0.0,France,2,3,6,11,2010
Vancouver 2010,0.0,Australia,2,1,0,3,2010
Vancouver 2010,0.0,Czech Republic,2,0,4,6,2010
Vancouver 2010,0.0,Poland,1,3,2,6,2010
Vancouver 2010,0.0,Italy,1,1,3,5,2010
Vancouver 2010,0.0,Slovakia,1,1,1,3,2010
Vancouver 2010,0.0,Belarus,1,1,1,3,2010
Vancouver 2010,0.0,Great Britain,1,0,0,1,2010
Vancouver 2010,0.0,Japan,0,3,2,5,2010
Vancouver 2010,0.0,Slovenia,0,2,1,3,2010
Vancouver 2010,0.0,Croatia,0,2,1,3,2010
Vancouver 2010,0.0,Latvia,0,2,0,2,2010
Vancouver 2010,0.0,Finland,0,1,4,5,2010
Vancouver 2010,0.0,Kazakhstan,0,1,0,1,2010
Vancouver 2010,0.0,Estonia,0,1,0,1,2010
London 2012,1.0,United States of America,46,28,30,104,2012
London 2012,1.0,People's Republic of China,38,31,22,91,2012
London 2012,1.0,Great Britain,29,17,19,65,2012
London 2012,1.0,Russian Federation,20,19,28,67,2012
London 2012,1.0,Republic of Korea,13,9,8,30,2012
London 2012,1.0,Germany,11,20,13,44,2012
London 2012,1.0,France,11,11,13,35,2012
London 2012,1.0,Australia,8,15,12,35,2012
London 2012,1.0,Italy,8,9,11,28,2012
London 2012,1.0,Hungary,8,4,6,18,2012
London 2012,1.0,Japan,7,14,17,38,2012
London 2012,1.0,Netherlands,6,6,8,20,2012
London 2012,1.0,Islamic Republic of Iran,6,6,1,13,2012
London 2012,1.0,New Zealand,6,2,5,13,2012
London 2012,1.0,Ukraine,5,4,10,19,2012
London 2012,1.0,Cuba,5,3,7,15,2012
London 2012,1.0,Spain,4,10,4,18,2012
London 2012,1.0,Jamaica,4,5,3,12,2012
London 2012,1.0,Czech Republic,4,3,4,11,2012
London 2012,1.0,South Africa,4,1,1,6,2012
London 2012,1.0,Democratic People's Republic of Korea,4,0,2,6,2012
London 2012,1.0,Brazil,3,5,9,17,2012
London 2012,1.0,Ethiopia,3,2,2,7,2012
London 2012,1.0,Kazakhstan,3,1,7,11,2012
London 2012,1.0,Poland,3,1,7,11,2012
London 2012,1.0,Croatia,3,1,2,6,2012
London 2012,1.0,Canada,2,5,11,18,2012
London 2012,1.0,Belarus,2,5,3,10,2012
London 2012,1.0,Romania,2,5,2,9,2012
London 2012,1.0,Kenya,2,4,6,12,2012
London 2012,1.0,Denmark,2,4,3,9,2012
London 2012,1.0,Azerbaijan,2,2,6,10,2012
London 2012,1.0,Switzerland,2,2,0,4,2012
London 2012,1.0,Norway,2,1,1,4,2012
London 2012,1.0,Lithuania,2,0,3,5,2012
London 2012,1.0,Tunisia,2,0,1,3,2012
London 2012,1.0,Sweden,1,4,3,8,2012
London 2012,1.0,Mexico,1,3,4,8,2012
London 2012,1.0,Colombia,1,3,4,8,2012
London 2012,1.0,Georgia,1,2,3,6,2012
London 2012,1.0,Ireland,1,1,4,6,2012
London 2012,1.0,Argentina,1,1,2,4,2012
London 2012,1.0,Slovenia,1,1,2,4,2012
London 2012,1.0,Serbia,1,1,2,4,2012
London 2012,1.0,Trinidad and Tobago,1,1,2,4,2012
London 2012,1.0,Turkey,1,1,1,3,2012
London 2012,1.0,Dominican Republic,1,1,0,2,2012
London 2012,1.0,Latvia,1,0,1,2,2012
London 2012,1.0,Chinese Taipei,1,0,1,2,2012
London 2012,1.0,Grenada,1,0,0,1,2012
London 2012,1.0,Bahrain,1,0,0,1,2012
London 2012,1.0,Venezuela,1,0,0,1,2012
London 2012,1.0,Algeria,1,0,0,1,2012
London 2012,1.0,Uganda,1,0,0,1,2012
London 2012,1.0,Bahamas,1,0,0,1,2012
London 2012,1.0,Egypt,0,3,1,4,2012
London 2012,1.0,India,0,2,4,6,2012
London 2012,1.0,Mongolia,0,2,3,5,2012
London 2012,1.0,Thailand,0,2,2,4,2012
London 2012,1.0,Bulgaria,0,2,1,3,2012
London 2012,1.0,Finland,0,2,1,3,2012
London 2012,1.0,Indonesia,0,2,1,3,2012
London 2012,1.0,Slovakia,0,1,3,4,2012
London 2012,1.0,Belgium,0,1,2,3,2012
London 2012,1.0,Puerto Rico,0,1,1,2,2012
London 2012,1.0,Estonia,0,1,1,2,2012
London 2012,1.0,Armenia,0,1,1,2,2012
London 2012,1.0,Malaysia,0,1,1,2,2012
London 2012,1.0,Botswana,0,1,0,1,2012
London 2012,1.0,Guatemala,0,1,0,1,2012
London 2012,1.0,Portugal,0,1,0,1,2012
London 2012,1.0,Montenegro,0,1,0,1,2012
London 2012,1.0,Gabon,0,1,0,1,2012
London 2012,1.0,Cyprus,0,1,0,1,2012
London 2012,1.0,Qatar,0,0,2,2,2012
London 2012,1.0,Greece,0,0,2,2,2012
London 2012,1.0,Singapore,0,0,2,2,2012
London 2012,1.0,Uzbekistan,0,0,2,2,2012
London 2012,1.0,Saudi Arabia,0,0,1,1,2012
London 2012,1.0,Kuwait,0,0,1,1,2012
London 2012,1.0,Afghanistan,0,0,1,1,2012
London 2012,1.0,"Hong Kong, China",0,0,1,1,2012
London 2012,1.0,Tajikistan,0,0,1,1,2012
London 2012,1.0,Cameroon,0,0,1,1,2012
London 2012,1.0,Morocco,0,0,1,1,2012
Sochi 2014,0.0,Russian Federation,11,9,9,29,2014
Sochi 2014,0.0,Norway,11,5,10,26,2014
Sochi 2014,0.0,Canada,10,10,5,25,2014
Sochi 2014,0.0,United States of America,9,9,10,28,2014
Sochi 2014,0.0,Netherlands,8,7,9,24,2014
Sochi 2014,0.0,Germany,8,6,5,19,2014
Sochi 2014,0.0,Switzerland,7,2,2,11,2014
Sochi 2014,0.0,Belarus,5,0,1,6,2014
Sochi 2014,0.0,Austria,4,8,5,17,2014
Sochi 2014,0.0,France,4,4,7,15,2014
Sochi 2014,0.0,Poland,4,1,1,6,2014
Sochi 2014,0.0,People's Republic of China,3,4,2,9,2014
Sochi 2014,0.0,Republic of Korea,3,3,2,8,2014
Sochi 2014,0.0,Sweden,2,7,6,15,2014
Sochi 2014,0.0,Czech Republic,2,4,2,8,2014
Sochi 2014,0.0,Slovenia,2,2,4,8,2014
Sochi 2014,0.0,Japan,1,4,3,8,2014
Sochi 2014,0.0,Finland,1,3,1,5,2014
Sochi 2014,0.0,Latvia,1,1,3,5,2014
Sochi 2014,0.0,Great Britain,1,1,3,5,2014
Sochi 2014,0.0,Ukraine,1,0,1,2,2014
Sochi 2014,0.0,Slovakia,1,0,0,1,2014
Sochi 2014,0.0,Italy,0,2,6,8,2014
Sochi 2014,0.0,Australia,0,2,1,3,2014
Sochi 2014,0.0,Croatia,0,1,0,1,2014
Sochi 2014,0.0,Kazakhstan,0,0,1,1,2014
Rio 2016,1.0,United States of America,46,37,38,121,2016
Rio 2016,1.0,Great Britain,27,23,17,67,2016
Rio 2016,1.0,People's Republic of China,26,18,26,70,2016
Rio 2016,1.0,Russian Federation,19,17,20,56,2016
Rio 2016,1.0,Germany,17,10,15,42,2016
Rio 2016,1.0,Japan,12,8,21,41,2016
Rio 2016,1.0,France,10,18,14,42,2016
Rio 2016,1.0,Republic of Korea,9,3,9,21,2016
Rio 2016,1.0,Italy,8,12,8,28,2016
Rio 2016,1.0,Australia,8,11,10,29,2016
Rio 2016,1.0,Netherlands,8,7,4,19,2016
Rio 2016,1.0,Hungary,8,3,4,15,2016
Rio 2016,1.0,Brazil,7,6,6,19,2016
Rio 2016,1.0,Spain,7,4,6,17,2016
Rio 2016,1.0,Kenya,6,6,1,13,2016
Rio 2016,1.0,Jamaica,6,3,2,11,2016
Rio 2016,1.0,Croatia,5,3,2,10,2016
Rio 2016,1.0,Cuba,5,2,4,11,2016
Rio 2016,1.0,New Zealand,4,9,5,18,2016
Rio 2016,1.0,Canada,4,3,15,22,2016
Rio 2016,1.0,Uzbekistan,4,2,7,13,2016
Rio 2016,1.0,Kazakhstan,3,5,10,18,2016
Rio 2016,1.0,Colombia,3,2,3,8,2016
Rio 2016,1.0,Switzerland,3,2,2,7,2016
Rio 2016,1.0,Islamic Republic of Iran,3,1,4,8,2016
Rio 2016,1.0,Greece,3,1,2,6,2016
Rio 2016,1.0,Argentina,3,1,0,4,2016
Rio 2016,1.0,Denmark,2,6,7,15,2016
Rio 2016,1.0,Sweden,2,6,3,11,2016
Rio 2016,1.0,South Africa,2,6,2,10,2016
Rio 2016,1.0,Ukraine,2,5,4,11,2016
Rio 2016,1.0,Serbia,2,4,2,8,2016
Rio 2016,1.0,Poland,2,3,6,11,2016
Rio 2016,1.0,Democratic People's Republic of Korea,2,3,2,7,2016
Rio 2016,1.0,Thailand,2,2,2,6,2016
Rio 2016,1.0,Belgium,2,2,2,6,2016
Rio 2016,1.0,Slovakia,2,2,0,4,2016
Rio 2016,1.0,Georgia,2,1,4,7,2016
Rio 2016,1.0,Azerbaijan,1,7,10,18,2016
Rio 2016,1.0,Belarus,1,4,4,9,2016
Rio 2016,1.0,Turkey,1,3,4,8,2016
Rio 2016,1.0,Armenia,1,3,0,4,2016
Rio 2016,1.0,Czech Republic,1,2,7,10,2016
Rio 2016,1.0,Ethiopia,1,2,5,8,2016
Rio 2016,1.0,Slovenia,1,2,1,4,2016
Rio 2016,1.0,Indonesia,1,2,0,3,2016
Rio 2016,1.0,Romania,1,1,2,4,2016
Rio 2016,1.0,Bahrain,1,1,0,2,2016
Rio 2016,1.0,Vietnam,1,1,0,2,2016
Rio 2016,1.0,Chinese Taipei,1,0,2,3,2016
Rio 2016,1.0,Côte d'Ivoire,1,0,1,2,2016
Rio 2016,1.0,Bahamas,1,0,1,2,2016
Rio 2016,1.0,Independent Olympic Athletes,1,0,1,2,2016
Rio 2016,1.0,Kosovo,1,0,0,1,2016
Rio 2016,1.0,Puerto Rico,1,0,0,1,2016
Rio 2016,1.0,Tajikistan,1,0,0,1,2016
Rio 2016,1.0,Fiji,1,0,0,1,2016
Rio 2016,1.0,Singapore,1,0,0,1,2016
Rio 2016,1.0,Jordan,1,0,0,1,2016
Rio 2016,1.0,Malaysia,0,4,1,5,2016
Rio 2016,1.0,Mexico,0,3,2,5,2016
Rio 2016,1.0,Venezuela,0,2,1,3,2016
Rio 2016,1.0,Ireland,0,2,0,2,2016
Rio 2016,1.0,Algeria,0,2,0,2,2016
Rio 2016,1.0,Lithuania,0,1,3,4,2016
Rio 2016,1.0,Bulgaria,0,1,2,3,2016
Rio 2016,1.0,India,0,1,1,2,2016
Rio 2016,1.0,Mongolia,0,1,1,2,2016
Rio 2016,1.0,Burundi,0,1,0,1,2016
Rio 2016,1.0,Philippines,0,1,0,1,2016
Rio 2016,1.0,Qatar,0,1,0,1,2016
Rio 2016,1.0,Grenada,0,1,0,1,2016
Rio 2016,1.0,Niger,0,1,0,1,2016
Rio 2016,1.0,Norway,0,0,4,4,2016
Rio 2016,1.0,Tunisia,0,0,3,3,2016
Rio 2016,1.0,Egypt,0,0,3,3,2016
Rio 2016,1.0,Israel,0,0,2,2,2016
Rio 2016,1.0,Trinidad and Tobago,0,0,1,1,2016
Rio 2016,1.0,Morocco,0,0,1,1,2016
Rio 2016,1.0,Nigeria,0,0,1,1,2016
Rio 2016,1.0,Finland,0,0,1,1,2016
Rio 2016,1.0,Estonia,0,0,1,1,2016
Rio 2016,1.0,Dominican Republic,0,0,1,1,2016
Rio 2016,1.0,Austria,0,0,1,1,2016
Rio 2016,1.0,United Arab Emirates,0,0,1,1,2016
Rio 2016,1.0,Portugal,0,0,1,1,2016
PyeongChang 2018,0.0,Norway,14,14,11,39,2018
PyeongChang 2018,0.0,Germany,14,10,7,31,2018
PyeongChang 2018,0.0,Canada,11,8,10,29,2018
PyeongChang 2018,0.0,United States of America,9,8,6,23,2018
PyeongChang 2018,0.0,Netherlands,8,6,6,20,2018
PyeongChang 2018,0.0,Sweden,7,6,1,14,2018
PyeongChang 2018,0.0,Republic of Korea,5,8,4,17,2018
PyeongChang 2018,0.0,Switzerland,5,6,4,15,2018
PyeongChang 2018,0.0,France,5,4,6,15,2018
PyeongChang 2018,0.0,Austria,5,3,6,14,2018
PyeongChang 2018,0.0,Japan,4,5,4,13,2018
PyeongChang 2018,0.0,Italy,3,2,5,10,2018
PyeongChang 2018,0.0,Olympic Athletes from Russia,2,6,9,17,2018
PyeongChang 2018,0.0,Czech Republic,2,2,3,7,2018
PyeongChang 2018,0.0,Belarus,2,1,0,3,2018
PyeongChang 2018,0.0,People's Republic of China,1,6,2,9,2018
PyeongChang 2018,0.0,Slovakia,1,2,0,3,2018
PyeongChang 2018,0.0,Finland,1,1,4,6,2018
PyeongChang 2018,0.0,Great Britain,1,0,4,5,2018
PyeongChang 2018,0.0,Poland,1,0,1,2,2018
PyeongChang 2018,0.0,Ukraine,1,0,0,1,2018
PyeongChang 2018,0.0,Hungary,1,0,0,1,2018
PyeongChang 2018,0.0,Australia,0,2,1,3,2018
PyeongChang 2018,0.0,Slovenia,0,1,1,2,2018
PyeongChang 2018,0.0,Belgium,0,1,0,1,2018
PyeongChang 2018,0.0,New Zealand,0,0,2,2,2018
PyeongChang 2018,0.0,Spain,0,0,2,2,2018
PyeongChang 2018,0.0,Kazakhstan,0,0,1,1,2018
PyeongChang 2018,0.0,Liechtenstein,0,0,1,1,2018
PyeongChang 2018,0.0,Latvia,0,0,1,1,2018
Tokyo 2020,1.0,United States of America,39,41,33,113,2020
Tokyo 2020,1.0,People's Republic of China,38,32,18,88,2020
Tokyo 2020,1.0,Japan,27,14,17,58,2020
Tokyo 2020,1.0,Great Britain,22,21,22,65,2020
Tokyo 2020,1.0,ROC,20,28,23,71,2020
Tokyo 2020,1.0,Australia,17,7,22,46,2020
Tokyo 2020,1.0,Netherlands,10,12,14,36,2020
Tokyo 2020,1.0,France,10,12,11,33,2020
Tokyo 2020,1.0,Germany,10,11,16,37,2020
Tokyo 2020,1.0,Italy,10,10,20,40,2020
Tokyo 2020,1.0,Canada,7,6,11,24,2020
Tokyo 2020,1.0,Brazil,7,6,8,21,2020
Tokyo 2020,1.0,New Zealand,7,6,7,20,2020
Tokyo 2020,1.0,Cuba,7,3,5,15,2020
Tokyo 2020,1.0,Hungary,6,7,7,20,2020
Tokyo 2020,1.0,Republic of Korea,6,4,10,20,2020
Tokyo 2020,1.0,Poland,4,5,5,14,2020
Tokyo 2020,1.0,Czech Republic,4,4,3,11,2020
Tokyo 2020,1.0,Kenya,4,4,2,10,2020
Tokyo 2020,1.0,Norway,4,2,2,8,2020
Tokyo 2020,1.0,Jamaica,4,1,4,9,2020
Tokyo 2020,1.0,Spain,3,8,6,17,2020
Tokyo 2020,1.0,Sweden,3,6,0,9,2020
Tokyo 2020,1.0,Switzerland,3,4,6,13,2020
Tokyo 2020,1.0,Denmark,3,4,4,11,2020
Tokyo 2020,1.0,Croatia,3,3,2,8,2020
Tokyo 2020,1.0,Islamic Republic of Iran,3,2,2,7,2020
Tokyo 2020,1.0,Serbia,3,1,5,9,2020
Tokyo 2020,1.0,Belgium,3,1,3,7,2020
Tokyo 2020,1.0,Bulgaria,3,1,2,6,2020
Tokyo 2020,1.0,Slovenia,3,1,1,5,2020
Tokyo 2020,1.0,Uzbekistan,3,0,2,5,2020
Tokyo 2020,1.0,Georgia,2,5,1,8,2020
Tokyo 2020,1.0,Chinese Taipei,2,4,6,12,2020
Tokyo 2020,1.0,Turkey,2,2,9,13,2020
Tokyo 2020,1.0,Greece,2,1,1,4,2020
Tokyo 2020,1.0,Uganda,2,1,1,4,2020
Tokyo 2020,1.0,Ecuador,2,1,0,3,2020
Tokyo 2020,1.0,Israel,2,0,2,4,2020
Tokyo 2020,1.0,Ireland,2,0,2,4,2020
Tokyo 2020,1.0,Qatar,2,0,1,3,2020
Tokyo 2020,1.0,Bahamas,2,0,0,2,2020
Tokyo 2020,1.0,Kosovo,2,0,0,2,2020
Tokyo 2020,1.0,Ukraine,1,6,12,19,2020
Tokyo 2020,1.0,Belarus,1,3,3,7,2020
Tokyo 2020,1.0,Venezuela,1,3,0,4,2020
Tokyo 2020,1.0,Romania,1,3,0,4,2020
Tokyo 2020,1.0,India,1,2,4,7,2020
Tokyo 2020,1.0,"Hong Kong, China",1,2,3,6,2020
Tokyo 2020,1.0,Slovakia,1,2,1,4,2020
Tokyo 2020,1.0,Philippines,1,2,1,4,2020
Tokyo 2020,1.0,South Africa,1,2,0,3,2020
Tokyo 2020,1.0,Austria,1,1,5,7,2020
Tokyo 2020,1.0,Egypt,1,1,4,6,2020
Tokyo 2020,1.0,Indonesia,1,1,3,5,2020
Tokyo 2020,1.0,Portugal,1,1,2,4,2020
Tokyo 2020,1.0,Ethiopia,1,1,2,4,2020
Tokyo 2020,1.0,Tunisia,1,1,0,2,2020
Tokyo 2020,1.0,Fiji,1,0,1,2,2020
Tokyo 2020,1.0,Latvia,1,0,1,2,2020
Tokyo 2020,1.0,Estonia,1,0,1,2,2020
Tokyo 2020,1.0,Thailand,1,0,1,2,2020
Tokyo 2020,1.0,Morocco,1,0,0,1,2020
Tokyo 2020,1.0,Puerto Rico,1,0,0,1,2020
Tokyo 2020,1.0,Bermuda,1,0,0,1,2020
Tokyo 2020,1.0,Colombia,0,4,1,5,2020
Tokyo 2020,1.0,Azerbaijan,0,3,4,7,2020
Tokyo 2020,1.0,Dominican Republic,0,3,2,5,2020
Tokyo 2020,1.0,Armenia,0,2,2,4,2020
Tokyo 2020,1.0,Kyrgyzstan,0,2,1,3,2020
Tokyo 2020,1.0,Mongolia,0,1,3,4,2020
Tokyo 2020,1.0,San Marino,0,1,2,3,2020
Tokyo 2020,1.0,Argentina,0,1,2,3,2020
Tokyo 2020,1.0,Malaysia,0,1,1,2,2020
Tokyo 2020,1.0,Nigeria,0,1,1,2,2020
Tokyo 2020,1.0,Jordan,0,1,1,2,2020
Tokyo 2020,1.0,Bahrain,0,1,0,1,2020
Tokyo 2020,1.0,Saudi Arabia,0,1,0,1,2020
Tokyo 2020,1.0,Lithuania,0,1,0,1,2020
Tokyo 2020,1.0,North Macedonia,0,1,0,1,2020
Tokyo 2020,1.0,Namibia,0,1,0,1,2020
Tokyo 2020,1.0,Turkmenistan,0,1,0,1,2020
Tokyo 2020,1.0,Kazakhstan,0,0,8,8,2020
Tokyo 2020,1.0,Mexico,0,0,4,4,2020
Tokyo 2020,1.0,Finland,0,0,2,2,2020
Tokyo 2020,1.0,Republic of Moldova,0,0,1,1,2020
Tokyo 2020,1.0,Grenada,0,0,1,1,2020
Tokyo 2020,1.0,Ghana,0,0,1,1,2020
Tokyo 2020,1.0,Burkina Faso,0,0,1,1,2020
Tokyo 2020,1.0,Côte d'Ivoire,0,0,1,1,2020
Tokyo 2020,1.0,Botswana,0,0,1,1,2020
Tokyo 2020,1.0,Kuwait,0,0,1,1,2020
Tokyo 2020,1.0,Syrian Arab Republic,0,0,1,1,2020
