games,summer,team,gold,silver,bronze,total,year,games_team
Athens 1896,1,Great Britain,2,3,2,7,1896,Athens 1896 | Great Britain
Athens 1896,1,Austria,2,1,2,5,1896,Athens 1896 | Austria
Athens 1896,1,Switzerland,1,2,0,3,1896,Athens 1896 | Switzerland
Athens 1896,1,Denmark,1,2,3,6,1896,Athens 1896 | Denmark
Athens 1896,1,Australia,2,0,0,2,1896,Athens 1896 | Australia
Athens 1896,1,Hungary,2,1,3,6,1896,Athens 1896 | Hungary
Athens 1896,1,MIX,1,0,1,2,1896,Athens 1896 | MIX
Athens 1896,1,Greece,10,18,19,47,1896,Athens 1896 | Greece
Athens 1896,1,France,5,4,2,11,1896,Athens 1896 | France
Athens 1896,1,Germany,6,5,2,13,1896,Athens 1896 | Germany
Athens 1896,1,United States of America,11,7,2,20,1896,Athens 1896 | United States of America
Paris 1900,1,Germany,4,3,2,9,1900,Paris 1900 | Germany
Paris 1900,1,Hungary,1,2,2,5,1900,Paris 1900 | Hungary
Paris 1900,1,Belgium,6,7,4,17,1900,Paris 1900 | Belgium
Paris 1900,1,Denmark,1,3,2,6,1900,Paris 1900 | Denmark
Paris 1900,1,MIX,8,5,6,19,1900,Paris 1900 | MIX
Paris 1900,1,Austria,0,3,3,6,1900,Paris 1900 | Austria
Paris 1900,1,Italy,3,2,0,5,1900,Paris 1900 | Italy
Paris 1900,1,Great Britain,15,8,9,32,1900,Paris 1900 | Great Britain
Paris 1900,1,Australia,2,0,3,5,1900,Paris 1900 | Australia
Paris 1900,1,Switzerland,6,2,1,9,1900,Paris 1900 | Switzerland
Paris 1900,1,Sweden,0,0,1,1,1900,Paris 1900 | Sweden
Paris 1900,1,Netherlands,0,2,3,5,1900,Paris 1900 | Netherlands
Paris 1900,1,United States of America,19,14,15,48,1900,Paris 1900 | United States of America
Paris 1900,1,Luxembourg,1,0,0,1,1900,Paris 1900 | Luxembourg
Paris 1900,1,France,27,38,37,102,1900,Paris 1900 | France
Paris 1900,1,Spain,1,0,0,1,1900,Paris 1900 | Spain
Paris 1900,1,Bohemia,0,1,1,2,1900,Paris 1900 | Bohemia
Paris 1900,1,India,0,2,0,2,1900,Paris 1900 | India
Paris 1900,1,Cuba,1,1,0,2,1900,Paris 1900 | Cuba
Paris 1900,1,Norway,0,2,3,5,1900,Paris 1900 | Norway
Paris 1900,1,Canada,1,0,1,2,1900,Paris 1900 | Canada
St. Louis 1904,1,France,0,1,0,1,1904,St. Louis 1904 | France
St. Louis 1904,1,Germany,4,5,6,15,1904,St. Louis 1904 | Germany
St. Louis 1904,1,Greece,1,0,1,2,1904,St. Louis 1904 | Greece
St. Louis 1904,1,Hungary,2,1,1,4,1904,St. Louis 1904 | Hungary
St. Louis 1904,1,Norway,2,0,0,2,1904,St. Louis 1904 | Norway
St. Louis 1904,1,Switzerland,1,0,2,3,1904,St. Louis 1904 | Switzerland
St. Louis 1904,1,Austria,1,1,1,3,1904,St. Louis 1904 | Austria
St. Louis 1904,1,Cuba,3,0,0,3,1904,St. Louis 1904 | Cuba
St. Louis 1904,1,Australia,0,3,1,4,1904,St. Louis 1904 | Australia
St. Louis 1904,1,MIX,2,1,1,4,1904,St. Louis 1904 | MIX
St. Louis 1904,1,Canada,4,1,1,6,1904,St. Louis 1904 | Canada
St. Louis 1904,1,Great Britain,1,1,0,2,1904,St. Louis 1904 | Great Britain
St. Louis 1904,1,United States of America,78,82,79,239,1904,St. Louis 1904 | United States of America
London 1908,1,Australasia,1,2,2,5,1908,London 1908 | Australasia
London 1908,1,Norway,2,3,3,8,1908,London 1908 | Norway
London 1908,1,France,5,5,9,19,1908,London 1908 | France
London 1908,1,Italy,2,2,0,4,1908,London 1908 | Italy
London 1908,1,Belgium,1,5,2,8,1908,London 1908 | Belgium
London 1908,1,Austria,0,0,1,1,1908,London 1908 | Austria
London 1908,1,United States of America,23,12,12,47,1908,London 1908 | United States of America
London 1908,1,Great Britain,56,51,39,146,1908,London 1908 | Great Britain
London 1908,1,Denmark,0,2,3,5,1908,London 1908 | Denmark
London 1908,1,South Africa,1,1,0,2,1908,London 1908 | South Africa
London 1908,1,Sweden,8,6,11,25,1908,London 1908 | Sweden
London 1908,1,Bohemia,0,0,2,2,1908,London 1908 | Bohemia
London 1908,1,Germany,3,5,5,13,1908,London 1908 | Germany
London 1908,1,Netherlands,0,0,2,2,1908,London 1908 | Netherlands
London 1908,1,Hungary,3,4,2,9,1908,London 1908 | Hungary
London 1908,1,Canada,3,3,10,16,1908,London 1908 | Canada
London 1908,1,Greece,0,3,1,4,1908,London 1908 | Greece
London 1908,1,Finland,1,1,3,5,1908,London 1908 | Finland
London 1908,1,Russian Federation,1,2,0,3,1908,London 1908 | Russian Federation
Stockholm 1912,1,Norway,4,1,5,10,1912,Stockholm 1912 | Norway
Stockholm 1912,1,Hungary,3,2,3,8,1912,Stockholm 1912 | Hungary
Stockholm 1912,1,Great Britain,10,15,16,41,1912,Stockholm 1912 | Great Britain
Stockholm 1912,1,Canada,3,2,3,8,1912,Stockholm 1912 | Canada
Stockholm 1912,1,Finland,9,8,9,26,1912,Stockholm 1912 | Finland
Stockholm 1912,1,Germany,6,13,7,26,1912,Stockholm 1912 | Germany
Stockholm 1912,1,Belgium,2,1,3,6,1912,Stockholm 1912 | Belgium
Stockholm 1912,1,France,7,5,3,15,1912,Stockholm 1912 | France
Stockholm 1912,1,Switzerland,1,0,0,1,1912,Stockholm 1912 | Switzerland
Stockholm 1912,1,Sweden,24,24,17,65,1912,Stockholm 1912 | Sweden
Stockholm 1912,1,Greece,1,0,1,2,1912,Stockholm 1912 | Greece
Stockholm 1912,1,Austria,0,2,2,4,1912,Stockholm 1912 | Austria
Stockholm 1912,1,Denmark,1,6,5,12,1912,Stockholm 1912 | Denmark
Stockholm 1912,1,Russian Federation,0,2,3,5,1912,Stockholm 1912 | Russian Federation
Stockholm 1912,1,United States of America,26,19,19,64,1912,Stockholm 1912 | United States of America
Stockholm 1912,1,Netherlands,0,0,3,3,1912,Stockholm 1912 | Netherlands
Stockholm 1912,1,Italy,5,1,2,8,1912,Stockholm 1912 | Italy
Stockholm 1912,1,Australasia,2,2,3,7,1912,Stockholm 1912 | Australasia
Stockholm 1912,1,South Africa,4,2,0,6,1912,Stockholm 1912 | South Africa
Antwerp 1920,1,Australia,0,2,1,3,1920,Antwerp 1920 | Australia
Antwerp 1920,1,Finland,15,10,9,34,1920,Antwerp 1920 | Finland
Antwerp 1920,1,United States of America,41,27,27,95,1920,Antwerp 1920 | United States of America
Antwerp 1920,1,Canada,3,3,3,9,1920,Antwerp 1920 | Canada
Antwerp 1920,1,New Zealand,0,0,1,1,1920,Antwerp 1920 | New Zealand
Antwerp 1920,1,Norway,13,10,9,32,1920,Antwerp 1920 | Norway
Antwerp 1920,1,Great Britain,14,16,13,43,1920,Antwerp 1920 | Great Britain
Antwerp 1920,1,Brazil,1,1,1,3,1920,Antwerp 1920 | Brazil
Antwerp 1920,1,France,9,20,13,42,1920,Antwerp 1920 | France
Antwerp 1920,1,Spain,0,2,0,2,1920,Antwerp 1920 | Spain
Antwerp 1920,1,Japan,0,2,0,2,1920,Antwerp 1920 | Japan
Antwerp 1920,1,Estonia,1,2,0,3,1920,Antwerp 1920 | Estonia
Antwerp 1920,1,Greece,0,1,0,1,1920,Antwerp 1920 | Greece
Antwerp 1920,1,Denmark,3,9,1,13,1920,Antwerp 1920 | Denmark
Antwerp 1920,1,Netherlands,4,2,5,11,1920,Antwerp 1920 | Netherlands
Antwerp 1920,1,Czechoslovakia,0,0,2,2,1920,Antwerp 1920 | Czechoslovakia
Antwerp 1920,1,Switzerland,2,2,7,11,1920,Antwerp 1920 | Switzerland
Antwerp 1920,1,Italy,14,6,5,25,1920,Antwerp 1920 | Italy
Antwerp 1920,1,Belgium,16,12,14,42,1920,Antwerp 1920 | Belgium
Antwerp 1920,1,South Africa,3,4,3,10,1920,Antwerp 1920 | South Africa
Antwerp 1920,1,Sweden,19,20,25,64,1920,Antwerp 1920 | Sweden
Antwerp 1920,1,Luxembourg,0,1,0,1,1920,Antwerp 1920 | Luxembourg
Chamonix 1924,0,MIX,1,0,0,1,1924,Chamonix 1924 | MIX
Chamonix 1924,0,Canada,1,0,0,1,1924,Chamonix 1924 | Canada
Paris 1924,1,Argentina,1,3,2,6,1924,Paris 1924 | Argentina
Chamonix 1924,0,Sweden,1,1,0,2,1924,Chamonix 1924 | Sweden
Paris 1924,1,Australia,3,1,2,6,1924,Paris 1924 | Australia
Paris 1924,1,Switzerland,7,8,10,25,1924,Paris 1924 | Switzerland
Paris 1924,1,Greece,1,0,0,1,1924,Paris 1924 | Greece
Paris 1924,1,Sweden,4,13,12,29,1924,Paris 1924 | Sweden
Paris 1924,1,Uruguay,1,0,0,1,1924,Paris 1924 | Uruguay
Paris 1924,1,Estonia,1,1,4,6,1924,Paris 1924 | Estonia
Paris 1924,1,Yugoslavia,2,0,0,2,1924,Paris 1924 | Yugoslavia
Paris 1924,1,Luxembourg,1,1,0,2,1924,Paris 1924 | Luxembourg
Paris 1924,1,Czechoslovakia,1,4,5,10,1924,Paris 1924 | Czechoslovakia
Paris 1924,1,Japan,0,0,1,1,1924,Paris 1924 | Japan
Chamonix 1924,0,Belgium,0,0,1,1,1924,Chamonix 1924 | Belgium
Paris 1924,1,France,14,15,12,41,1924,Paris 1924 | France
Paris 1924,1,Hungary,2,4,4,10,1924,Paris 1924 | Hungary
Paris 1924,1,Norway,5,2,3,10,1924,Paris 1924 | Norway
Chamonix 1924,0,United States of America,1,2,1,4,1924,Chamonix 1924 | United States of America
Paris 1924,1,Denmark,2,6,3,11,1924,Paris 1924 | Denmark
Paris 1924,1,Netherlands,4,1,6,11,1924,Paris 1924 | Netherlands
Chamonix 1924,0,Great Britain,1,1,2,4,1924,Chamonix 1924 | Great Britain
Paris 1924,1,Great Britain,9,14,12,35,1924,Paris 1924 | Great Britain
Chamonix 1924,0,Finland,4,4,3,11,1924,Chamonix 1924 | Finland
Chamonix 1924,0,Norway,4,7,6,17,1924,Chamonix 1924 | Norway
Paris 1924,1,Italy,8,3,5,16,1924,Paris 1924 | Italy
Paris 1924,1,Belgium,3,7,3,13,1924,Paris 1924 | Belgium
Paris 1924,1,Canada,0,3,1,4,1924,Paris 1924 | Canada
Paris 1924,1,Austria,0,3,1,4,1924,Paris 1924 | Austria
Chamonix 1924,0,Switzerland,2,0,1,3,1924,Chamonix 1924 | Switzerland
Chamonix 1924,0,Austria,2,1,0,3,1924,Chamonix 1924 | Austria
Paris 1924,1,South Africa,1,1,1,3,1924,Paris 1924 | South Africa
Paris 1924,1,Portugal,0,0,1,1,1924,Paris 1924 | Portugal
Paris 1924,1,Poland,0,1,1,2,1924,Paris 1924 | Poland
Paris 1924,1,Finland,14,13,10,37,1924,Paris 1924 | Finland
Paris 1924,1,United States of America,45,27,27,99,1924,Paris 1924 | United States of America
Paris 1924,1,New Zealand,0,0,1,1,1924,Paris 1924 | New Zealand
Paris 1924,1,Haiti,0,0,1,1,1924,Paris 1924 | Haiti
Paris 1924,1,Ireland,0,1,1,2,1924,Paris 1924 | Ireland
Paris 1924,1,Monaco,0,0,1,1,1924,Paris 1924 | Monaco
Chamonix 1924,0,France,0,0,3,3,1924,Chamonix 1924 | France
Paris 1924,1,Romania,0,0,1,1,1924,Paris 1924 | Romania
St. Moritz 1928,0,Belgium,0,0,1,1,1928,St. Moritz 1928 | Belgium
Amsterdam 1928,1,Philippines,0,0,1,1,1928,Amsterdam 1928 | Philippines
Amsterdam 1928,1,Uruguay,1,0,0,1,1928,Amsterdam 1928 | Uruguay
St. Moritz 1928,0,Norway,6,4,5,15,1928,St. Moritz 1928 | Norway
Amsterdam 1928,1,Portugal,0,0,1,1,1928,Amsterdam 1928 | Portugal
St. Moritz 1928,0,Germany,0,0,1,1,1928,St. Moritz 1928 | Germany
Amsterdam 1928,1,Argentina,3,3,1,7,1928,Amsterdam 1928 | Argentina
Amsterdam 1928,1,Italy,7,6,7,20,1928,Amsterdam 1928 | Italy
St. Moritz 1928,0,Great Britain,0,0,1,1,1928,St. Moritz 1928 | Great Britain
Amsterdam 1928,1,Finland,8,8,9,25,1928,Amsterdam 1928 | Finland
Amsterdam 1928,1,Chile,0,1,0,1,1928,Amsterdam 1928 | Chile
Amsterdam 1928,1,New Zealand,1,0,0,1,1928,Amsterdam 1928 | New Zealand
Amsterdam 1928,1,Haiti,0,1,0,1,1928,Amsterdam 1928 | Haiti
Amsterdam 1928,1,Great Britain,4,11,7,22,1928,Amsterdam 1928 | Great Britain
Amsterdam 1928,1,India,1,0,0,1,1928,Amsterdam 1928 | India
Amsterdam 1928,1,Switzerland,7,6,4,17,1928,Amsterdam 1928 | Switzerland
Amsterdam 1928,1,Sweden,7,6,12,25,1928,Amsterdam 1928 | Sweden
St. Moritz 1928,0,Switzerland,0,0,1,1,1928,St. Moritz 1928 | Switzerland
Amsterdam 1928,1,Denmark,3,2,4,9,1928,Amsterdam 1928 | Denmark
Amsterdam 1928,1,Spain,1,0,0,1,1928,Amsterdam 1928 | Spain
Amsterdam 1928,1,Luxembourg,1,0,0,1,1928,Amsterdam 1928 | Luxembourg
St. Moritz 1928,0,Czechoslovakia,0,0,1,1,1928,St. Moritz 1928 | Czechoslovakia
Amsterdam 1928,1,Netherlands,8,10,5,23,1928,Amsterdam 1928 | Netherlands
Amsterdam 1928,1,Hungary,5,5,0,10,1928,Amsterdam 1928 | Hungary
Amsterdam 1928,1,Czechoslovakia,2,5,2,9,1928,Amsterdam 1928 | Czechoslovakia
Amsterdam 1928,1,Ireland,1,0,0,1,1928,Amsterdam 1928 | Ireland
St. Moritz 1928,0,Canada,1,0,0,1,1928,St. Moritz 1928 | Canada
Amsterdam 1928,1,France,7,12,6,25,1928,Amsterdam 1928 | France
St. Moritz 1928,0,France,1,0,0,1,1928,St. Moritz 1928 | France
Amsterdam 1928,1,Canada,4,4,7,15,1928,Amsterdam 1928 | Canada
Amsterdam 1928,1,Japan,2,2,1,5,1928,Amsterdam 1928 | Japan
Amsterdam 1928,1,Belgium,0,1,2,3,1928,Amsterdam 1928 | Belgium
Amsterdam 1928,1,South Africa,1,0,2,3,1928,Amsterdam 1928 | South Africa
Amsterdam 1928,1,Germany,11,9,19,39,1928,Amsterdam 1928 | Germany
Amsterdam 1928,1,Poland,2,1,4,7,1928,Amsterdam 1928 | Poland
Amsterdam 1928,1,Austria,3,0,1,4,1928,Amsterdam 1928 | Austria
Amsterdam 1928,1,Egypt,2,1,1,4,1928,Amsterdam 1928 | Egypt
Amsterdam 1928,1,United States of America,22,18,16,56,1928,Amsterdam 1928 | United States of America
St. Moritz 1928,0,United States of America,2,2,2,6,1928,St. Moritz 1928 | United States of America
Amsterdam 1928,1,Yugoslavia,1,1,3,5,1928,Amsterdam 1928 | Yugoslavia
St. Moritz 1928,0,Finland,2,1,1,4,1928,St. Moritz 1928 | Finland
Amsterdam 1928,1,Australia,1,2,1,4,1928,Amsterdam 1928 | Australia
St. Moritz 1928,0,Austria,0,3,1,4,1928,St. Moritz 1928 | Austria
Amsterdam 1928,1,Estonia,2,1,2,5,1928,Amsterdam 1928 | Estonia
Amsterdam 1928,1,Norway,1,2,1,4,1928,Amsterdam 1928 | Norway
St. Moritz 1928,0,Sweden,2,2,1,5,1928,St. Moritz 1928 | Sweden
Los Angeles 1932,1,India,1,0,0,1,1932,Los Angeles 1932 | India
Los Angeles 1932,1,Poland,3,2,4,9,1932,Los Angeles 1932 | Poland
Los Angeles 1932,1,Argentina,3,1,0,4,1932,Los Angeles 1932 | Argentina
Lake Placid 1932,0,France,1,0,0,1,1932,Lake Placid 1932 | France
Los Angeles 1932,1,Netherlands,2,5,1,8,1932,Los Angeles 1932 | Netherlands
Los Angeles 1932,1,Italy,12,12,12,36,1932,Los Angeles 1932 | Italy
Los Angeles 1932,1,Spain,0,0,1,1,1932,Los Angeles 1932 | Spain
Los Angeles 1932,1,Czechoslovakia,1,3,2,6,1932,Los Angeles 1932 | Czechoslovakia
Los Angeles 1932,1,Austria,1,1,3,5,1932,Los Angeles 1932 | Austria
Los Angeles 1932,1,Uruguay,0,0,1,1,1932,Los Angeles 1932 | Uruguay
Los Angeles 1932,1,Belgium,0,0,1,1,1932,Los Angeles 1932 | Belgium
Lake Placid 1932,0,Hungary,0,0,1,1,1932,Lake Placid 1932 | Hungary
Los Angeles 1932,1,Ireland,2,0,0,2,1932,Los Angeles 1932 | Ireland
Los Angeles 1932,1,South Africa,2,0,3,5,1932,Los Angeles 1932 | South Africa
Lake Placid 1932,0,Austria,1,1,0,2,1932,Lake Placid 1932 | Austria
Los Angeles 1932,1,Australia,3,1,1,5,1932,Los Angeles 1932 | Australia
Los Angeles 1932,1,United States of America,44,36,30,110,1932,Los Angeles 1932 | United States of America
Los Angeles 1932,1,France,11,5,4,20,1932,Los Angeles 1932 | France
Los Angeles 1932,1,Philippines,0,0,3,3,1932,Los Angeles 1932 | Philippines
Lake Placid 1932,0,Norway,3,4,3,10,1932,Lake Placid 1932 | Norway
Los Angeles 1932,1,Finland,5,8,12,25,1932,Los Angeles 1932 | Finland
Los Angeles 1932,1,New Zealand,0,1,0,1,1932,Los Angeles 1932 | New Zealand
Los Angeles 1932,1,Canada,2,5,9,16,1932,Los Angeles 1932 | Canada
Los Angeles 1932,1,Hungary,6,5,5,16,1932,Los Angeles 1932 | Hungary
Lake Placid 1932,0,Canada,1,1,5,7,1932,Lake Placid 1932 | Canada
Los Angeles 1932,1,Switzerland,0,1,0,1,1932,Los Angeles 1932 | Switzerland
Lake Placid 1932,0,United States of America,6,4,2,12,1932,Lake Placid 1932 | United States of America
Los Angeles 1932,1,Denmark,0,5,3,8,1932,Los Angeles 1932 | Denmark
Los Angeles 1932,1,Latvia,0,1,0,1,1932,Los Angeles 1932 | Latvia
Lake Placid 1932,0,Switzerland,0,1,0,1,1932,Lake Placid 1932 | Switzerland
Los Angeles 1932,1,Mexico,0,2,0,2,1932,Los Angeles 1932 | Mexico
Lake Placid 1932,0,Sweden,1,2,0,3,1932,Lake Placid 1932 | Sweden
Los Angeles 1932,1,Japan,7,7,4,18,1932,Los Angeles 1932 | Japan
Los Angeles 1932,1,Germany,5,12,7,24,1932,Los Angeles 1932 | Germany
Los Angeles 1932,1,Great Britain,5,7,5,17,1932,Los Angeles 1932 | Great Britain
Lake Placid 1932,0,Germany,0,0,2,2,1932,Lake Placid 1932 | Germany
Lake Placid 1932,0,Finland,1,1,1,3,1932,Lake Placid 1932 | Finland
Los Angeles 1932,1,Sweden,10,5,9,24,1932,Los Angeles 1932 | Sweden
Berlin 1936,1,Austria,5,7,5,17,1936,Berlin 1936 | Austria
Garmisch-Partenkirchen 1936,0,Norway,7,5,3,15,1936,Garmisch-Partenkirchen 1936 | Norway
Berlin 1936,1,Yugoslavia,0,1,0,1,1936,Berlin 1936 | Yugoslavia
Garmisch-Partenkirchen 1936,0,United States of America,1,0,3,4,1936,Garmisch-Partenkirchen 1936 | United States of America
Garmisch-Partenkirchen 1936,0,Austria,1,1,2,4,1936,Garmisch-Partenkirchen 1936 | Austria
Berlin 1936,1,Finland,8,6,6,20,1936,Berlin 1936 | Finland
Berlin 1936,1,Egypt,2,1,2,5,1936,Berlin 1936 | Egypt
Berlin 1936,1,Romania,0,1,0,1,1936,Berlin 1936 | Romania
Berlin 1936,1,India,1,0,0,1,1936,Berlin 1936 | India
Berlin 1936,1,United States of America,24,21,12,57,1936,Berlin 1936 | United States of America
Berlin 1936,1,Japan,6,4,10,20,1936,Berlin 1936 | Japan
Berlin 1936,1,Hungary,10,1,5,16,1936,Berlin 1936 | Hungary
Garmisch-Partenkirchen 1936,0,Canada,0,1,0,1,1936,Garmisch-Partenkirchen 1936 | Canada
Berlin 1936,1,Czechoslovakia,3,5,1,9,1936,Berlin 1936 | Czechoslovakia
Berlin 1936,1,New Zealand,1,0,0,1,1936,Berlin 1936 | New Zealand
Garmisch-Partenkirchen 1936,0,Great Britain,1,1,1,3,1936,Garmisch-Partenkirchen 1936 | Great Britain
Berlin 1936,1,Netherlands,6,4,7,17,1936,Berlin 1936 | Netherlands
Berlin 1936,1,Belgium,0,0,3,3,1936,Berlin 1936 | Belgium
Berlin 1936,1,Switzerland,4,9,5,18,1936,Berlin 1936 | Switzerland
Berlin 1936,1,Mexico,0,0,3,3,1936,Berlin 1936 | Mexico
Berlin 1936,1,Denmark,0,2,3,5,1936,Berlin 1936 | Denmark
Garmisch-Partenkirchen 1936,0,Switzerland,1,2,0,3,1936,Garmisch-Partenkirchen 1936 | Switzerland
Berlin 1936,1,France,7,6,6,19,1936,Berlin 1936 | France
Berlin 1936,1,South Africa,0,1,0,1,1936,Berlin 1936 | South Africa
Berlin 1936,1,Germany,38,31,32,101,1936,Berlin 1936 | Germany
Berlin 1936,1,Latvia,0,1,1,2,1936,Berlin 1936 | Latvia
Berlin 1936,1,Sweden,6,5,10,21,1936,Berlin 1936 | Sweden
Berlin 1936,1,Great Britain,4,7,3,14,1936,Berlin 1936 | Great Britain
Berlin 1936,1,Philippines,0,0,1,1,1936,Berlin 1936 | Philippines
Berlin 1936,1,Portugal,0,0,1,1,1936,Berlin 1936 | Portugal
Garmisch-Partenkirchen 1936,0,Germany,3,3,0,6,1936,Garmisch-Partenkirchen 1936 | Germany
Berlin 1936,1,Australia,0,0,1,1,1936,Berlin 1936 | Australia
Berlin 1936,1,Italy,9,13,5,27,1936,Berlin 1936 | Italy
Garmisch-Partenkirchen 1936,0,Sweden,2,2,3,7,1936,Garmisch-Partenkirchen 1936 | Sweden
Berlin 1936,1,Argentina,2,2,3,7,1936,Berlin 1936 | Argentina
Berlin 1936,1,Turkey,1,0,1,2,1936,Berlin 1936 | Turkey
Garmisch-Partenkirchen 1936,0,France,0,0,1,1,1936,Garmisch-Partenkirchen 1936 | France
Berlin 1936,1,Poland,0,4,5,9,1936,Berlin 1936 | Poland
Berlin 1936,1,Estonia,2,2,3,7,1936,Berlin 1936 | Estonia
Berlin 1936,1,Norway,1,3,2,6,1936,Berlin 1936 | Norway
Garmisch-Partenkirchen 1936,0,Hungary,0,0,1,1,1936,Garmisch-Partenkirchen 1936 | Hungary
Garmisch-Partenkirchen 1936,0,Finland,1,2,3,6,1936,Garmisch-Partenkirchen 1936 | Finland
Berlin 1936,1,Canada,1,3,5,9,1936,Berlin 1936 | Canada
London 1948,1,Netherlands,5,2,9,16,1948,London 1948 | Netherlands
St. Moritz 1948,0,Great Britain,0,0,2,2,1948,St. Moritz 1948 | Great Britain
London 1948,1,Sweden,17,11,18,46,1948,London 1948 | Sweden
London 1948,1,Puerto Rico,0,0,1,1,1948,London 1948 | Puerto Rico
London 1948,1,Czechoslovakia,6,2,3,11,1948,London 1948 | Czechoslovakia
London 1948,1,United States of America,38,27,19,84,1948,London 1948 | United States of America
London 1948,1,Finland,10,8,6,24,1948,London 1948 | Finland
St. Moritz 1948,0,Canada,2,0,1,3,1948,St. Moritz 1948 | Canada
London 1948,1,South Africa,2,2,2,6,1948,London 1948 | South Africa
London 1948,1,Jamaica,1,2,0,3,1948,London 1948 | Jamaica
London 1948,1,Hungary,10,5,13,28,1948,London 1948 | Hungary
London 1948,1,Portugal,0,1,1,2,1948,London 1948 | Portugal
London 1948,1,Spain,0,1,0,1,1948,London 1948 | Spain
London 1948,1,Belgium,2,2,3,7,1948,London 1948 | Belgium
St. Moritz 1948,0,Austria,1,3,4,8,1948,St. Moritz 1948 | Austria
London 1948,1,Canada,0,2,2,4,1948,London 1948 | Canada
London 1948,1,Turkey,6,4,2,12,1948,London 1948 | Turkey
London 1948,1,Sri Lanka,0,1,0,1,1948,London 1948 | Sri Lanka
London 1948,1,Argentina,3,3,1,7,1948,London 1948 | Argentina
London 1948,1,Australia,2,6,5,13,1948,London 1948 | Australia
London 1948,1,Uruguay,0,1,1,2,1948,London 1948 | Uruguay
London 1948,1,Brazil,0,0,1,1,1948,London 1948 | Brazil
London 1948,1,Cuba,0,1,0,1,1948,London 1948 | Cuba
London 1948,1,Norway,1,3,3,7,1948,London 1948 | Norway
London 1948,1,Great Britain,4,16,7,27,1948,London 1948 | Great Britain
London 1948,1,Trinidad and Tobago,0,1,0,1,1948,London 1948 | Trinidad and Tobago
St. Moritz 1948,0,Czechoslovakia,0,1,0,1,1948,St. Moritz 1948 | Czechoslovakia
St. Moritz 1948,0,Hungary,0,1,0,1,1948,St. Moritz 1948 | Hungary
London 1948,1,Yugoslavia,0,2,0,2,1948,London 1948 | Yugoslavia
St. Moritz 1948,0,Sweden,4,3,3,10,1948,St. Moritz 1948 | Sweden
London 1948,1,Islamic Republic of Iran,0,0,1,1,1948,London 1948 | Islamic Republic of Iran
St. Moritz 1948,0,Norway,4,3,3,10,1948,St. Moritz 1948 | Norway
London 1948,1,Egypt,2,2,1,5,1948,London 1948 | Egypt
London 1948,1,France,11,6,15,32,1948,London 1948 | France
London 1948,1,Italy,9,12,10,31,1948,London 1948 | Italy
St. Moritz 1948,0,France,2,1,2,5,1948,St. Moritz 1948 | France
London 1948,1,Mexico,2,1,2,5,1948,London 1948 | Mexico
St. Moritz 1948,0,Belgium,1,1,0,2,1948,St. Moritz 1948 | Belgium
St. Moritz 1948,0,Finland,1,3,2,6,1948,St. Moritz 1948 | Finland
London 1948,1,Denmark,5,8,9,22,1948,London 1948 | Denmark
London 1948,1,Poland,1,0,1,2,1948,London 1948 | Poland
London 1948,1,Switzerland,5,12,6,23,1948,London 1948 | Switzerland
London 1948,1,Republic of Korea,0,0,2,2,1948,London 1948 | Republic of Korea
London 1948,1,Austria,2,2,4,8,1948,London 1948 | Austria
St. Moritz 1948,0,Italy,1,0,0,1,1948,St. Moritz 1948 | Italy
London 1948,1,Ireland,0,0,1,1,1948,London 1948 | Ireland
London 1948,1,Peru,1,0,0,1,1948,London 1948 | Peru
St. Moritz 1948,0,United States of America,3,4,2,9,1948,St. Moritz 1948 | United States of America
London 1948,1,India,1,0,0,1,1948,London 1948 | India
London 1948,1,Panama,0,0,2,2,1948,London 1948 | Panama
St. Moritz 1948,0,Switzerland,3,4,3,10,1948,St. Moritz 1948 | Switzerland
Helsinki 1952,1,Uruguay,0,0,2,2,1952,Helsinki 1952 | Uruguay
Oslo 1952,0,Finland,3,4,2,9,1952,Oslo 1952 | Finland
Helsinki 1952,1,Japan,1,6,2,9,1952,Helsinki 1952 | Japan
Helsinki 1952,1,Argentina,1,2,2,5,1952,Helsinki 1952 | Argentina
Helsinki 1952,1,Poland,1,2,1,4,1952,Helsinki 1952 | Poland
Helsinki 1952,1,Jamaica,2,3,0,5,1952,Helsinki 1952 | Jamaica
Oslo 1952,0,Great Britain,1,0,0,1,1952,Oslo 1952 | Great Britain
Helsinki 1952,1,Great Britain,1,2,8,11,1952,Helsinki 1952 | Great Britain
Oslo 1952,0,Canada,1,0,1,2,1952,Oslo 1952 | Canada
Helsinki 1952,1,Spain,0,1,0,1,1952,Helsinki 1952 | Spain
Helsinki 1952,1,Ireland,0,1,0,1,1952,Helsinki 1952 | Ireland
Helsinki 1952,1,Turkey,2,0,1,3,1952,Helsinki 1952 | Turkey
Helsinki 1952,1,New Zealand,1,0,2,3,1952,Helsinki 1952 | New Zealand
Helsinki 1952,1,Mexico,0,1,0,1,1952,Helsinki 1952 | Mexico
Helsinki 1952,1,Czechoslovakia,7,3,3,13,1952,Helsinki 1952 | Czechoslovakia
Helsinki 1952,1,Switzerland,2,6,6,14,1952,Helsinki 1952 | Switzerland
Helsinki 1952,1,Brazil,1,0,2,3,1952,Helsinki 1952 | Brazil
Helsinki 1952,1,Netherlands,0,5,0,5,1952,Helsinki 1952 | Netherlands
Helsinki 1952,1,Norway,3,2,0,5,1952,Helsinki 1952 | Norway
Oslo 1952,0,United States of America,4,6,1,11,1952,Oslo 1952 | United States of America
Oslo 1952,0,Switzerland,0,0,2,2,1952,Oslo 1952 | Switzerland
Helsinki 1952,1,Luxembourg,1,0,0,1,1952,Helsinki 1952 | Luxembourg
Helsinki 1952,1,Yugoslavia,1,2,0,3,1952,Helsinki 1952 | Yugoslavia
Helsinki 1952,1,Canada,1,2,0,3,1952,Helsinki 1952 | Canada
Oslo 1952,0,Italy,1,0,1,2,1952,Oslo 1952 | Italy
Helsinki 1952,1,South Africa,2,4,4,10,1952,Helsinki 1952 | South Africa
Helsinki 1952,1,Republic of Korea,0,0,2,2,1952,Helsinki 1952 | Republic of Korea
Helsinki 1952,1,Chile,0,2,0,2,1952,Helsinki 1952 | Chile
Helsinki 1952,1,Denmark,2,1,3,6,1952,Helsinki 1952 | Denmark
Helsinki 1952,1,Belgium,2,2,0,4,1952,Helsinki 1952 | Belgium
Oslo 1952,0,Netherlands,0,3,0,3,1952,Oslo 1952 | Netherlands
Helsinki 1952,1,Australia,6,2,3,11,1952,Helsinki 1952 | Australia
Oslo 1952,0,Germany,3,2,2,7,1952,Oslo 1952 | Germany
Helsinki 1952,1,Austria,0,1,1,2,1952,Helsinki 1952 | Austria
Helsinki 1952,1,Lebanon,0,1,1,2,1952,Helsinki 1952 | Lebanon
Helsinki 1952,1,Trinidad and Tobago,0,0,2,2,1952,Helsinki 1952 | Trinidad and Tobago
Helsinki 1952,1,Romania,1,1,2,4,1952,Helsinki 1952 | Romania
Helsinki 1952,1,Islamic Republic of Iran,0,3,4,7,1952,Helsinki 1952 | Islamic Republic of Iran
Oslo 1952,0,Austria,2,4,2,8,1952,Oslo 1952 | Austria
Helsinki 1952,1,India,1,0,1,2,1952,Helsinki 1952 | India
Oslo 1952,0,Sweden,0,0,4,4,1952,Oslo 1952 | Sweden
Oslo 1952,0,Hungary,0,0,1,1,1952,Oslo 1952 | Hungary
Helsinki 1952,1,Germany,0,7,17,24,1952,Helsinki 1952 | Germany
Helsinki 1952,1,Bulgaria,0,0,1,1,1952,Helsinki 1952 | Bulgaria
Helsinki 1952,1,Hungary,16,10,16,42,1952,Helsinki 1952 | Hungary
Helsinki 1952,1,Portugal,0,0,1,1,1952,Helsinki 1952 | Portugal
Helsinki 1952,1,Venezuela,0,0,1,1,1952,Helsinki 1952 | Venezuela
Helsinki 1952,1,France,6,6,6,18,1952,Helsinki 1952 | France
Helsinki 1952,1,Italy,8,9,4,21,1952,Helsinki 1952 | Italy
Helsinki 1952,1,Sweden,12,13,10,35,1952,Helsinki 1952 | Sweden
Oslo 1952,0,France,0,0,1,1,1952,Oslo 1952 | France
Helsinki 1952,1,United States of America,40,19,17,76,1952,Helsinki 1952 | United States of America
Helsinki 1952,1,Soviet Union,22,30,19,71,1952,Helsinki 1952 | Soviet Union
Helsinki 1952,1,Finland,6,3,13,22,1952,Helsinki 1952 | Finland
Helsinki 1952,1,Egypt,0,0,1,1,1952,Helsinki 1952 | Egypt
Oslo 1952,0,Norway,7,3,6,16,1952,Oslo 1952 | Norway
Melbourne 1956,1,Poland,1,4,4,9,1956,Melbourne 1956 | Poland
Melbourne 1956,1,Bulgaria,1,3,1,5,1956,Melbourne 1956 | Bulgaria
Melbourne 1956,1,Sweden,5,5,6,16,1956,Melbourne 1956 | Sweden
Melbourne 1956,1,Denmark,1,1,1,3,1956,Melbourne 1956 | Denmark
Cortina D'Ampezzo 1956,0,Austria,4,3,4,11,1956,Cortina D'Ampezzo 1956 | Austria
Cortina D'Ampezzo 1956,0,Italy,1,2,0,3,1956,Cortina D'Ampezzo 1956 | Italy
Melbourne 1956,1,Romania,5,3,5,13,1956,Melbourne 1956 | Romania
Cortina D'Ampezzo 1956,0,Soviet Union,7,3,6,16,1956,Cortina D'Ampezzo 1956 | Soviet Union
Melbourne 1956,1,United States of America,32,25,17,74,1956,Melbourne 1956 | United States of America
Melbourne 1956,1,Canada,2,1,2,5,1956,Melbourne 1956 | Canada
Melbourne 1956,1,Great Britain,5,7,9,21,1956,Melbourne 1956 | Great Britain
Cortina D'Ampezzo 1956,0,Canada,0,1,2,3,1956,Cortina D'Ampezzo 1956 | Canada
Melbourne 1956,1,Brazil,1,0,0,1,1956,Melbourne 1956 | Brazil
Melbourne 1956,1,India,1,0,0,1,1956,Melbourne 1956 | India
Melbourne 1956,1,Yugoslavia,0,3,0,3,1956,Melbourne 1956 | Yugoslavia
Cortina D'Ampezzo 1956,0,Norway,2,1,1,4,1956,Cortina D'Ampezzo 1956 | Norway
Melbourne 1956,1,Ireland,1,1,3,5,1956,Melbourne 1956 | Ireland
Melbourne 1956,1,Australia,13,8,14,35,1956,Melbourne 1956 | Australia
Cortina D'Ampezzo 1956,0,Sweden,2,4,4,10,1956,Cortina D'Ampezzo 1956 | Sweden
Melbourne 1956,1,South Africa,0,0,4,4,1956,Melbourne 1956 | South Africa
Melbourne 1956,1,Japan,4,10,5,19,1956,Melbourne 1956 | Japan
Melbourne 1956,1,Norway,1,0,2,3,1956,Melbourne 1956 | Norway
Cortina D'Ampezzo 1956,0,Hungary,0,0,1,1,1956,Cortina D'Ampezzo 1956 | Hungary
Melbourne 1956,1,Soviet Union,37,29,32,98,1956,Melbourne 1956 | Soviet Union
Melbourne 1956,1,New Zealand,2,0,0,2,1956,Melbourne 1956 | New Zealand
Melbourne 1956,1,Germany,4,10,6,20,1956,Melbourne 1956 | Germany
Melbourne 1956,1,Islamic Republic of Iran,2,2,1,5,1956,Melbourne 1956 | Islamic Republic of Iran
Melbourne 1956,1,Austria,0,0,2,2,1956,Melbourne 1956 | Austria
Melbourne 1956,1,Italy,8,6,8,22,1956,Melbourne 1956 | Italy
Melbourne 1956,1,Chile,0,2,2,4,1956,Melbourne 1956 | Chile
Melbourne 1956,1,Argentina,0,1,1,2,1956,Melbourne 1956 | Argentina
Cortina D'Ampezzo 1956,0,United States of America,2,3,2,7,1956,Cortina D'Ampezzo 1956 | United States of America
Melbourne 1956,1,Finland,3,1,11,15,1956,Melbourne 1956 | Finland
Melbourne 1956,1,Hungary,9,10,7,26,1956,Melbourne 1956 | Hungary
Melbourne 1956,1,Greece,0,0,1,1,1956,Melbourne 1956 | Greece
Melbourne 1956,1,Uruguay,0,0,1,1,1956,Melbourne 1956 | Uruguay
Melbourne 1956,1,Bahamas,0,0,1,1,1956,Melbourne 1956 | Bahamas
Melbourne 1956,1,Turkey,3,2,2,7,1956,Melbourne 1956 | Turkey
Melbourne 1956,1,France,4,4,6,14,1956,Melbourne 1956 | France
Cortina D'Ampezzo 1956,0,Finland,3,3,1,7,1956,Cortina D'Ampezzo 1956 | Finland
Melbourne 1956,1,Republic of Korea,0,1,1,2,1956,Melbourne 1956 | Republic of Korea
Cortina D'Ampezzo 1956,0,Poland,0,0,1,1,1956,Cortina D'Ampezzo 1956 | Poland
Cortina D'Ampezzo 1956,0,Japan,0,1,0,1,1956,Cortina D'Ampezzo 1956 | Japan
Cortina D'Ampezzo 1956,0,Switzerland,3,2,1,6,1956,Cortina D'Ampezzo 1956 | Switzerland
Melbourne 1956,1,Czechoslovakia,1,4,1,6,1956,Melbourne 1956 | Czechoslovakia
Cortina D'Ampezzo 1956,0,Germany,1,0,1,2,1956,Cortina D'Ampezzo 1956 | Germany
Melbourne 1956,1,Mexico,1,0,1,2,1956,Melbourne 1956 | Mexico
Melbourne 1956,1,Iceland,0,1,0,1,1956,Melbourne 1956 | Iceland
Melbourne 1956,1,Pakistan,0,1,0,1,1956,Melbourne 1956 | Pakistan
Melbourne 1956,1,Belgium,0,2,0,2,1956,Melbourne 1956 | Belgium
Rome 1960,1,Spain,0,0,1,1,1960,Rome 1960 | Spain
Rome 1960,1,Turkey,7,2,0,9,1960,Rome 1960 | Turkey
Rome 1960,1,Iraq,0,0,1,1,1960,Rome 1960 | Iraq
Rome 1960,1,France,0,2,3,5,1960,Rome 1960 | France
Squaw Valley 1960,0,Norway,3,3,0,6,1960,Squaw Valley 1960 | Norway
Rome 1960,1,Norway,1,0,0,1,1960,Rome 1960 | Norway
Rome 1960,1,Italy,13,10,13,36,1960,Rome 1960 | Italy
Rome 1960,1,Romania,3,1,6,10,1960,Rome 1960 | Romania
Rome 1960,1,Ethiopia,1,0,0,1,1960,Rome 1960 | Ethiopia
Rome 1960,1,Finland,1,1,3,5,1960,Rome 1960 | Finland
Rome 1960,1,Greece,1,0,0,1,1960,Rome 1960 | Greece
Squaw Valley 1960,0,United States of America,3,4,3,10,1960,Squaw Valley 1960 | United States of America
Rome 1960,1,Bulgaria,1,3,3,7,1960,Rome 1960 | Bulgaria
Rome 1960,1,Japan,4,7,7,18,1960,Rome 1960 | Japan
Rome 1960,1,Sweden,1,2,3,6,1960,Rome 1960 | Sweden
Rome 1960,1,Great Britain,2,6,12,20,1960,Rome 1960 | Great Britain
Squaw Valley 1960,0,Poland,0,1,1,2,1960,Squaw Valley 1960 | Poland
Squaw Valley 1960,0,Austria,1,2,3,6,1960,Squaw Valley 1960 | Austria
Rome 1960,1,Brazil,0,0,2,2,1960,Rome 1960 | Brazil
Rome 1960,1,West Indies Federation,0,0,2,2,1960,Rome 1960 | West Indies Federation
Rome 1960,1,Czechoslovakia,3,2,3,8,1960,Rome 1960 | Czechoslovakia
Rome 1960,1,Australia,8,8,6,22,1960,Rome 1960 | Australia
Rome 1960,1,Austria,1,1,0,2,1960,Rome 1960 | Austria
Rome 1960,1,Yugoslavia,1,1,0,2,1960,Rome 1960 | Yugoslavia
Squaw Valley 1960,0,Germany,4,3,1,8,1960,Squaw Valley 1960 | Germany
Rome 1960,1,Switzerland,0,3,3,6,1960,Rome 1960 | Switzerland
Rome 1960,1,Pakistan,1,0,1,2,1960,Rome 1960 | Pakistan
Rome 1960,1,Denmark,2,3,1,6,1960,Rome 1960 | Denmark
Squaw Valley 1960,0,Soviet Union,7,5,9,21,1960,Squaw Valley 1960 | Soviet Union
Squaw Valley 1960,0,Sweden,3,2,2,7,1960,Squaw Valley 1960 | Sweden
Rome 1960,1,Hungary,6,8,7,21,1960,Rome 1960 | Hungary
Rome 1960,1,Venezuela,0,0,1,1,1960,Rome 1960 | Venezuela
Rome 1960,1,Poland,4,6,11,21,1960,Rome 1960 | Poland
Rome 1960,1,Argentina,0,1,1,2,1960,Rome 1960 | Argentina
Rome 1960,1,United Arab Republic,0,1,1,2,1960,Rome 1960 | United Arab Republic
Squaw Valley 1960,0,Netherlands,0,1,1,2,1960,Squaw Valley 1960 | Netherlands
Squaw Valley 1960,0,Finland,2,3,3,8,1960,Squaw Valley 1960 | Finland
Squaw Valley 1960,0,Switzerland,2,0,0,2,1960,Squaw Valley 1960 | Switzerland
Rome 1960,1,Mexico,0,0,1,1,1960,Rome 1960 | Mexico
Rome 1960,1,South Africa,0,1,2,3,1960,Rome 1960 | South Africa
Squaw Valley 1960,0,Italy,0,0,1,1,1960,Squaw Valley 1960 | Italy
Rome 1960,1,Morocco,0,1,0,1,1960,Rome 1960 | Morocco
Squaw Valley 1960,0,Czechoslovakia,0,1,0,1,1960,Squaw Valley 1960 | Czechoslovakia
Rome 1960,1,Chinese Taipei,0,1,0,1,1960,Rome 1960 | Chinese Taipei
Rome 1960,1,New Zealand,2,0,1,3,1960,Rome 1960 | New Zealand
Rome 1960,1,Ghana,0,1,0,1,1960,Rome 1960 | Ghana
Rome 1960,1,Singapore,0,1,0,1,1960,Rome 1960 | Singapore
Rome 1960,1,Netherlands,0,1,2,3,1960,Rome 1960 | Netherlands
Rome 1960,1,Islamic Republic of Iran,0,1,3,4,1960,Rome 1960 | Islamic Republic of Iran
Rome 1960,1,Portugal,0,1,0,1,1960,Rome 1960 | Portugal
Rome 1960,1,India,0,1,0,1,1960,Rome 1960 | India
Rome 1960,1,Belgium,0,2,2,4,1960,Rome 1960 | Belgium
Rome 1960,1,Canada,0,1,0,1,1960,Rome 1960 | Canada
Rome 1960,1,Germany,12,19,11,42,1960,Rome 1960 | Germany
Rome 1960,1,Soviet Union,43,29,31,103,1960,Rome 1960 | Soviet Union
Squaw Valley 1960,0,Canada,2,1,1,4,1960,Squaw Valley 1960 | Canada
Rome 1960,1,United States of America,34,21,16,71,1960,Rome 1960 | United States of America
Squaw Valley 1960,0,France,1,0,2,3,1960,Squaw Valley 1960 | France
Tokyo 1964,1,Romania,2,4,6,12,1964,Tokyo 1964 | Romania
Tokyo 1964,1,Denmark,2,1,3,6,1964,Tokyo 1964 | Denmark
Innsbruck 1964,0,Canada,1,1,1,3,1964,Innsbruck 1964 | Canada
Tokyo 1964,1,Netherlands,2,4,4,10,1964,Tokyo 1964 | Netherlands
Innsbruck 1964,0,Netherlands,1,1,0,2,1964,Innsbruck 1964 | Netherlands
Innsbruck 1964,0,Czechoslovakia,0,0,1,1,1964,Innsbruck 1964 | Czechoslovakia
Tokyo 1964,1,United States of America,36,26,28,90,1964,Tokyo 1964 | United States of America
Tokyo 1964,1,Nigeria,0,0,1,1,1964,Tokyo 1964 | Nigeria
Tokyo 1964,1,Mexico,0,0,1,1,1964,Tokyo 1964 | Mexico
Tokyo 1964,1,Czechoslovakia,5,6,3,14,1964,Tokyo 1964 | Czechoslovakia
Tokyo 1964,1,Switzerland,1,2,1,4,1964,Tokyo 1964 | Switzerland
Tokyo 1964,1,Yugoslavia,2,1,2,5,1964,Tokyo 1964 | Yugoslavia
Tokyo 1964,1,Belgium,2,0,1,3,1964,Tokyo 1964 | Belgium
Tokyo 1964,1,Tunisia,0,1,1,2,1964,Tokyo 1964 | Tunisia
Innsbruck 1964,0,Austria,4,5,3,12,1964,Innsbruck 1964 | Austria
Innsbruck 1964,0,Germany,3,3,3,9,1964,Innsbruck 1964 | Germany
Tokyo 1964,1,Finland,3,0,2,5,1964,Tokyo 1964 | Finland
Tokyo 1964,1,New Zealand,3,0,2,5,1964,Tokyo 1964 | New Zealand
Tokyo 1964,1,Soviet Union,30,31,35,96,1964,Tokyo 1964 | Soviet Union
Innsbruck 1964,0,Sweden,3,3,1,7,1964,Innsbruck 1964 | Sweden
Tokyo 1964,1,Turkey,2,3,1,6,1964,Tokyo 1964 | Turkey
Tokyo 1964,1,Kenya,0,0,1,1,1964,Tokyo 1964 | Kenya
Innsbruck 1964,0,France,3,4,0,7,1964,Innsbruck 1964 | France
Tokyo 1964,1,Uruguay,0,0,1,1,1964,Tokyo 1964 | Uruguay
Innsbruck 1964,0,Democratic People's Republic of Korea,0,1,0,1,1964,Innsbruck 1964 | Democratic People's Republic of Korea
Tokyo 1964,1,Canada,1,2,1,4,1964,Tokyo 1964 | Canada
Innsbruck 1964,0,Norway,3,6,6,15,1964,Innsbruck 1964 | Norway
Tokyo 1964,1,Ethiopia,1,0,0,1,1964,Tokyo 1964 | Ethiopia
Tokyo 1964,1,Brazil,0,0,1,1,1964,Tokyo 1964 | Brazil
Tokyo 1964,1,Islamic Republic of Iran,0,0,2,2,1964,Tokyo 1964 | Islamic Republic of Iran
Tokyo 1964,1,Japan,16,5,8,29,1964,Tokyo 1964 | Japan
Innsbruck 1964,0,Great Britain,1,0,0,1,1964,Innsbruck 1964 | Great Britain
Tokyo 1964,1,Hungary,10,7,5,22,1964,Tokyo 1964 | Hungary
Tokyo 1964,1,France,1,8,6,15,1964,Tokyo 1964 | France
Tokyo 1964,1,Argentina,0,1,0,1,1964,Tokyo 1964 | Argentina
Tokyo 1964,1,Sweden,2,2,4,8,1964,Tokyo 1964 | Sweden
Tokyo 1964,1,Republic of Korea,0,2,1,3,1964,Tokyo 1964 | Republic of Korea
Tokyo 1964,1,Italy,10,10,7,27,1964,Tokyo 1964 | Italy
Tokyo 1964,1,Bahamas,1,0,0,1,1964,Tokyo 1964 | Bahamas
Tokyo 1964,1,Pakistan,0,1,0,1,1964,Tokyo 1964 | Pakistan
Tokyo 1964,1,Poland,7,6,10,23,1964,Tokyo 1964 | Poland
Innsbruck 1964,0,United States of America,1,2,4,7,1964,Innsbruck 1964 | United States of America
Tokyo 1964,1,Bulgaria,3,5,2,10,1964,Tokyo 1964 | Bulgaria
Tokyo 1964,1,Philippines,0,1,0,1,1964,Tokyo 1964 | Philippines
Tokyo 1964,1,Trinidad and Tobago,0,1,2,3,1964,Tokyo 1964 | Trinidad and Tobago
Tokyo 1964,1,Ireland,0,0,1,1,1964,Tokyo 1964 | Ireland
Tokyo 1964,1,Great Britain,4,12,2,18,1964,Tokyo 1964 | Great Britain
Tokyo 1964,1,Ghana,0,0,1,1,1964,Tokyo 1964 | Ghana
Innsbruck 1964,0,Finland,3,4,3,10,1964,Innsbruck 1964 | Finland
Tokyo 1964,1,Australia,6,2,10,18,1964,Tokyo 1964 | Australia
Innsbruck 1964,0,Soviet Union,11,8,6,25,1964,Innsbruck 1964 | Soviet Union
Innsbruck 1964,0,Italy,0,1,3,4,1964,Innsbruck 1964 | Italy
Tokyo 1964,1,Germany,10,22,18,50,1964,Tokyo 1964 | Germany
Tokyo 1964,1,Cuba,0,1,0,1,1964,Tokyo 1964 | Cuba
Tokyo 1964,1,India,1,0,0,1,1964,Tokyo 1964 | India
Mexico City 1968,1,Chinese Taipei,0,0,1,1,1968,Mexico City 1968 | Chinese Taipei
Mexico City 1968,1,Cuba,0,4,0,4,1968,Mexico City 1968 | Cuba
Grenoble 1968,0,Canada,1,1,1,3,1968,Grenoble 1968 | Canada
Mexico City 1968,1,Great Britain,5,5,3,13,1968,Mexico City 1968 | Great Britain
Mexico City 1968,1,Tunisia,1,0,1,2,1968,Mexico City 1968 | Tunisia
Mexico City 1968,1,Hungary,10,10,12,32,1968,Mexico City 1968 | Hungary
Mexico City 1968,1,Italy,3,4,9,16,1968,Mexico City 1968 | Italy
Mexico City 1968,1,Yugoslavia,3,3,2,8,1968,Mexico City 1968 | Yugoslavia
Mexico City 1968,1,German Democratic Republic (Germany),9,9,7,25,1968,Mexico City 1968 | German Democratic Republic (Germany)
Mexico City 1968,1,Greece,0,0,1,1,1968,Mexico City 1968 | Greece
Grenoble 1968,0,Romania,0,0,1,1,1968,Grenoble 1968 | Romania
Mexico City 1968,1,Argentina,0,0,2,2,1968,Mexico City 1968 | Argentina
Grenoble 1968,0,Switzerland,0,2,4,6,1968,Grenoble 1968 | Switzerland
Mexico City 1968,1,Denmark,1,4,3,8,1968,Mexico City 1968 | Denmark
Grenoble 1968,0,Sweden,3,2,3,8,1968,Grenoble 1968 | Sweden
Mexico City 1968,1,France,7,3,5,15,1968,Mexico City 1968 | France
Mexico City 1968,1,Norway,1,1,0,2,1968,Mexico City 1968 | Norway
Mexico City 1968,1,Ethiopia,1,1,0,2,1968,Mexico City 1968 | Ethiopia
Mexico City 1968,1,Czechoslovakia,7,2,4,13,1968,Mexico City 1968 | Czechoslovakia
Grenoble 1968,0,Soviet Union,5,5,3,13,1968,Grenoble 1968 | Soviet Union
Mexico City 1968,1,Republic of Korea,0,1,1,2,1968,Mexico City 1968 | Republic of Korea
Mexico City 1968,1,India,0,0,1,1,1968,Mexico City 1968 | India
Mexico City 1968,1,Belgium,0,1,1,2,1968,Mexico City 1968 | Belgium
Mexico City 1968,1,Uganda,0,1,1,2,1968,Mexico City 1968 | Uganda
Mexico City 1968,1,United States of America,45,28,34,107,1968,Mexico City 1968 | United States of America
Mexico City 1968,1,Japan,11,7,7,25,1968,Mexico City 1968 | Japan
Mexico City 1968,1,Poland,5,2,11,18,1968,Mexico City 1968 | Poland
Mexico City 1968,1,Federal Republic of Germany,5,11,10,26,1968,Mexico City 1968 | Federal Republic of Germany
Grenoble 1968,0,Italy,4,0,0,4,1968,Grenoble 1968 | Italy
Grenoble 1968,0,Federal Republic of Germany,2,2,3,7,1968,Grenoble 1968 | Federal Republic of Germany
Mexico City 1968,1,Switzerland,0,1,4,5,1968,Mexico City 1968 | Switzerland
Mexico City 1968,1,Cameroon,0,1,0,1,1968,Mexico City 1968 | Cameroon
Mexico City 1968,1,Jamaica,0,1,0,1,1968,Mexico City 1968 | Jamaica
Mexico City 1968,1,Mongolia,0,1,3,4,1968,Mexico City 1968 | Mongolia
Mexico City 1968,1,Pakistan,1,0,0,1,1968,Mexico City 1968 | Pakistan
Grenoble 1968,0,United States of America,1,5,1,7,1968,Grenoble 1968 | United States of America
Mexico City 1968,1,Venezuela,1,0,0,1,1968,Mexico City 1968 | Venezuela
Mexico City 1968,1,Romania,4,6,5,15,1968,Mexico City 1968 | Romania
Mexico City 1968,1,Brazil,0,1,2,3,1968,Mexico City 1968 | Brazil
Grenoble 1968,0,Austria,3,4,4,11,1968,Grenoble 1968 | Austria
Mexico City 1968,1,Soviet Union,29,32,30,91,1968,Mexico City 1968 | Soviet Union
Grenoble 1968,0,German Democratic Republic (Germany),1,2,2,5,1968,Grenoble 1968 | German Democratic Republic (Germany)
Mexico City 1968,1,Sweden,2,1,1,4,1968,Mexico City 1968 | Sweden
Grenoble 1968,0,Norway,6,6,2,14,1968,Grenoble 1968 | Norway
Mexico City 1968,1,Kenya,3,4,2,9,1968,Mexico City 1968 | Kenya
Grenoble 1968,0,Czechoslovakia,1,2,1,4,1968,Grenoble 1968 | Czechoslovakia
Grenoble 1968,0,Finland,1,2,2,5,1968,Grenoble 1968 | Finland
Mexico City 1968,1,Finland,1,2,1,4,1968,Mexico City 1968 | Finland
Mexico City 1968,1,Islamic Republic of Iran,2,1,2,5,1968,Mexico City 1968 | Islamic Republic of Iran
Mexico City 1968,1,Mexico,3,3,3,9,1968,Mexico City 1968 | Mexico
Mexico City 1968,1,Turkey,2,0,0,2,1968,Mexico City 1968 | Turkey
Mexico City 1968,1,Austria,0,2,2,4,1968,Mexico City 1968 | Austria
Grenoble 1968,0,France,4,3,2,9,1968,Grenoble 1968 | France
Mexico City 1968,1,Netherlands,3,3,1,7,1968,Mexico City 1968 | Netherlands
Mexico City 1968,1,New Zealand,1,0,2,3,1968,Mexico City 1968 | New Zealand
Mexico City 1968,1,Canada,1,3,1,5,1968,Mexico City 1968 | Canada
Mexico City 1968,1,Bulgaria,2,4,3,9,1968,Mexico City 1968 | Bulgaria
Mexico City 1968,1,Australia,5,7,5,17,1968,Mexico City 1968 | Australia
Grenoble 1968,0,Netherlands,3,3,3,9,1968,Grenoble 1968 | Netherlands
Sapporo 1972,0,Canada,0,1,0,1,1972,Sapporo 1972 | Canada
Munich 1972,1,Belgium,0,2,0,2,1972,Munich 1972 | Belgium
Munich 1972,1,United States of America,33,31,30,94,1972,Munich 1972 | United States of America
Sapporo 1972,0,German Democratic Republic (Germany),4,3,7,14,1972,Sapporo 1972 | German Democratic Republic (Germany)
Munich 1972,1,Lebanon,0,1,0,1,1972,Munich 1972 | Lebanon
Munich 1972,1,Greece,0,2,0,2,1972,Munich 1972 | Greece
Munich 1972,1,Pakistan,0,1,0,1,1972,Munich 1972 | Pakistan
Munich 1972,1,Japan,13,8,8,29,1972,Munich 1972 | Japan
Munich 1972,1,Argentina,0,1,0,1,1972,Munich 1972 | Argentina
Munich 1972,1,German Democratic Republic (Germany),20,23,23,66,1972,Munich 1972 | German Democratic Republic (Germany)
Munich 1972,1,Republic of Korea,0,1,0,1,1972,Munich 1972 | Republic of Korea
Munich 1972,1,Mongolia,0,1,0,1,1972,Munich 1972 | Mongolia
Munich 1972,1,Australia,8,7,2,17,1972,Munich 1972 | Australia
Munich 1972,1,Sweden,4,6,6,16,1972,Munich 1972 | Sweden
Munich 1972,1,Mexico,0,1,0,1,1972,Munich 1972 | Mexico
Munich 1972,1,Kenya,2,3,4,9,1972,Munich 1972 | Kenya
Munich 1972,1,Poland,7,5,9,21,1972,Munich 1972 | Poland
Munich 1972,1,Bulgaria,6,10,5,21,1972,Munich 1972 | Bulgaria
Munich 1972,1,New Zealand,1,1,1,3,1972,Munich 1972 | New Zealand
Sapporo 1972,0,Italy,2,2,1,5,1972,Sapporo 1972 | Italy
Munich 1972,1,Great Britain,4,5,9,18,1972,Munich 1972 | Great Britain
Munich 1972,1,Niger,0,0,1,1,1972,Munich 1972 | Niger
Sapporo 1972,0,France,0,1,2,3,1972,Sapporo 1972 | France
Munich 1972,1,Spain,0,0,1,1,1972,Munich 1972 | Spain
Munich 1972,1,India,0,0,1,1,1972,Munich 1972 | India
Munich 1972,1,Yugoslavia,2,1,2,5,1972,Munich 1972 | Yugoslavia
Munich 1972,1,Democratic People's Republic of Korea,1,1,3,5,1972,Munich 1972 | Democratic People's Republic of Korea
Munich 1972,1,Colombia,0,1,2,3,1972,Munich 1972 | Colombia
Munich 1972,1,Hungary,6,13,16,35,1972,Munich 1972 | Hungary
Sapporo 1972,0,Netherlands,4,3,2,9,1972,Sapporo 1972 | Netherlands
Sapporo 1972,0,Norway,2,5,5,12,1972,Sapporo 1972 | Norway
Sapporo 1972,0,Czechoslovakia,1,0,2,3,1972,Sapporo 1972 | Czechoslovakia
Munich 1972,1,Islamic Republic of Iran,0,2,1,3,1972,Munich 1972 | Islamic Republic of Iran
Sapporo 1972,0,Austria,1,2,2,5,1972,Sapporo 1972 | Austria
Sapporo 1972,0,Finland,0,4,1,5,1972,Sapporo 1972 | Finland
Sapporo 1972,0,Switzerland,4,3,3,10,1972,Sapporo 1972 | Switzerland
Munich 1972,1,Norway,2,1,1,4,1972,Munich 1972 | Norway
Munich 1972,1,Switzerland,0,3,0,3,1972,Munich 1972 | Switzerland
Munich 1972,1,Federal Republic of Germany,13,11,16,40,1972,Munich 1972 | Federal Republic of Germany
Munich 1972,1,Austria,0,1,2,3,1972,Munich 1972 | Austria
Munich 1972,1,France,2,4,7,13,1972,Munich 1972 | France
Sapporo 1972,0,Japan,1,1,1,3,1972,Sapporo 1972 | Japan
Munich 1972,1,Ghana,0,0,1,1,1972,Munich 1972 | Ghana
Munich 1972,1,Denmark,1,0,0,1,1972,Munich 1972 | Denmark
Munich 1972,1,Czechoslovakia,2,4,2,8,1972,Munich 1972 | Czechoslovakia
Munich 1972,1,Uganda,1,1,0,2,1972,Munich 1972 | Uganda
Munich 1972,1,Cuba,3,1,4,8,1972,Munich 1972 | Cuba
Munich 1972,1,Finland,3,1,4,8,1972,Munich 1972 | Finland
Sapporo 1972,0,United States of America,3,2,3,8,1972,Sapporo 1972 | United States of America
Munich 1972,1,Romania,3,6,7,16,1972,Munich 1972 | Romania
Munich 1972,1,Tunisia,0,1,0,1,1972,Munich 1972 | Tunisia
Sapporo 1972,0,Soviet Union,8,5,3,16,1972,Sapporo 1972 | Soviet Union
Munich 1972,1,Ethiopia,0,0,2,2,1972,Munich 1972 | Ethiopia
Munich 1972,1,Brazil,0,0,2,2,1972,Munich 1972 | Brazil
Sapporo 1972,0,Federal Republic of Germany,3,1,1,5,1972,Sapporo 1972 | Federal Republic of Germany
Munich 1972,1,Soviet Union,50,27,22,99,1972,Munich 1972 | Soviet Union
Munich 1972,1,Canada,0,2,3,5,1972,Munich 1972 | Canada
Munich 1972,1,Jamaica,0,0,1,1,1972,Munich 1972 | Jamaica
Munich 1972,1,Netherlands,3,1,1,5,1972,Munich 1972 | Netherlands
Munich 1972,1,Turkey,0,1,0,1,1972,Munich 1972 | Turkey
Munich 1972,1,Nigeria,0,0,1,1,1972,Munich 1972 | Nigeria
Munich 1972,1,Italy,5,3,10,18,1972,Munich 1972 | Italy
Sapporo 1972,0,Spain,1,0,0,1,1972,Sapporo 1972 | Spain
Sapporo 1972,0,Sweden,1,1,2,4,1972,Sapporo 1972 | Sweden
Sapporo 1972,0,Poland,1,0,0,1,1972,Sapporo 1972 | Poland
Montreal 1976,1,Federal Republic of Germany,10,12,17,39,1976,Montreal 1976 | Federal Republic of Germany
Montreal 1976,1,Portugal,0,2,0,2,1976,Montreal 1976 | Portugal
Innsbruck 1976,0,Soviet Union,13,6,8,27,1976,Innsbruck 1976 | Soviet Union
Montreal 1976,1,Netherlands,0,2,3,5,1976,Montreal 1976 | Netherlands
Montreal 1976,1,Spain,0,2,0,2,1976,Montreal 1976 | Spain
Montreal 1976,1,Australia,0,1,4,5,1976,Montreal 1976 | Australia
Montreal 1976,1,Finland,4,2,0,6,1976,Montreal 1976 | Finland
Innsbruck 1976,0,Netherlands,1,2,3,6,1976,Innsbruck 1976 | Netherlands
Montreal 1976,1,Puerto Rico,0,0,1,1,1976,Montreal 1976 | Puerto Rico
Montreal 1976,1,Jamaica,1,1,0,2,1976,Montreal 1976 | Jamaica
Montreal 1976,1,Norway,1,1,0,2,1976,Montreal 1976 | Norway
Montreal 1976,1,Democratic People's Republic of Korea,1,1,0,2,1976,Montreal 1976 | Democratic People's Republic of Korea
Montreal 1976,1,Republic of Korea,1,1,4,6,1976,Montreal 1976 | Republic of Korea
Montreal 1976,1,Switzerland,1,1,2,4,1976,Montreal 1976 | Switzerland
Montreal 1976,1,Belgium,0,3,3,6,1976,Montreal 1976 | Belgium
Montreal 1976,1,Sweden,4,1,0,5,1976,Montreal 1976 | Sweden
Montreal 1976,1,Mexico,1,0,1,2,1976,Montreal 1976 | Mexico
Innsbruck 1976,0,Austria,2,2,2,6,1976,Innsbruck 1976 | Austria
Innsbruck 1976,0,Canada,1,1,1,3,1976,Innsbruck 1976 | Canada
Innsbruck 1976,0,Italy,1,2,1,4,1976,Innsbruck 1976 | Italy
Montreal 1976,1,United States of America,34,35,25,94,1976,Montreal 1976 | United States of America
Montreal 1976,1,Soviet Union,49,41,35,125,1976,Montreal 1976 | Soviet Union
Innsbruck 1976,0,Switzerland,1,3,1,5,1976,Innsbruck 1976 | Switzerland
Montreal 1976,1,Bermuda,0,0,1,1,1976,Montreal 1976 | Bermuda
Montreal 1976,1,Austria,0,0,1,1,1976,Montreal 1976 | Austria
Montreal 1976,1,Denmark,1,0,2,3,1976,Montreal 1976 | Denmark
Montreal 1976,1,New Zealand,2,1,1,4,1976,Montreal 1976 | New Zealand
Montreal 1976,1,Thailand,0,0,1,1,1976,Montreal 1976 | Thailand
Innsbruck 1976,0,France,0,0,1,1,1976,Innsbruck 1976 | France
Montreal 1976,1,Pakistan,0,0,1,1,1976,Montreal 1976 | Pakistan
Montreal 1976,1,Romania,4,9,14,27,1976,Montreal 1976 | Romania
Montreal 1976,1,Trinidad and Tobago,1,0,0,1,1976,Montreal 1976 | Trinidad and Tobago
Innsbruck 1976,0,Norway,3,3,1,7,1976,Innsbruck 1976 | Norway
Montreal 1976,1,German Democratic Republic (Germany),40,25,25,90,1976,Montreal 1976 | German Democratic Republic (Germany)
Montreal 1976,1,Islamic Republic of Iran,0,1,1,2,1976,Montreal 1976 | Islamic Republic of Iran
Innsbruck 1976,0,German Democratic Republic (Germany),7,5,7,19,1976,Innsbruck 1976 | German Democratic Republic (Germany)
Montreal 1976,1,France,2,3,4,9,1976,Montreal 1976 | France
Montreal 1976,1,Venezuela,0,1,0,1,1976,Montreal 1976 | Venezuela
Montreal 1976,1,Great Britain,3,5,5,13,1976,Montreal 1976 | Great Britain
Montreal 1976,1,Italy,2,7,4,13,1976,Montreal 1976 | Italy
Montreal 1976,1,Japan,9,6,10,25,1976,Montreal 1976 | Japan
Montreal 1976,1,Hungary,4,5,13,22,1976,Montreal 1976 | Hungary
Montreal 1976,1,Bulgaria,6,9,7,22,1976,Montreal 1976 | Bulgaria
Innsbruck 1976,0,Liechtenstein,0,0,2,2,1976,Innsbruck 1976 | Liechtenstein
Montreal 1976,1,Mongolia,0,1,0,1,1976,Montreal 1976 | Mongolia
Innsbruck 1976,0,Czechoslovakia,0,1,0,1,1976,Innsbruck 1976 | Czechoslovakia
Innsbruck 1976,0,Sweden,0,0,2,2,1976,Innsbruck 1976 | Sweden
Montreal 1976,1,Brazil,0,0,2,2,1976,Montreal 1976 | Brazil
Montreal 1976,1,Czechoslovakia,2,2,4,8,1976,Montreal 1976 | Czechoslovakia
Innsbruck 1976,0,Federal Republic of Germany,2,5,3,10,1976,Innsbruck 1976 | Federal Republic of Germany
Innsbruck 1976,0,United States of America,3,3,4,10,1976,Innsbruck 1976 | United States of America
Montreal 1976,1,Yugoslavia,2,3,3,8,1976,Montreal 1976 | Yugoslavia
Montreal 1976,1,Poland,7,6,13,26,1976,Montreal 1976 | Poland
Innsbruck 1976,0,Finland,2,4,1,7,1976,Innsbruck 1976 | Finland
Montreal 1976,1,Cuba,6,4,3,13,1976,Montreal 1976 | Cuba
Innsbruck 1976,0,Great Britain,1,0,0,1,1976,Innsbruck 1976 | Great Britain
Montreal 1976,1,Canada,0,5,6,11,1976,Montreal 1976 | Canada
Moscow 1980,1,India,1,0,0,1,1980,Moscow 1980 | India
Lake Placid 1980,0,Bulgaria,0,0,1,1,1980,Lake Placid 1980 | Bulgaria
Moscow 1980,1,Sweden,3,3,6,12,1980,Moscow 1980 | Sweden
Moscow 1980,1,Hungary,7,10,15,32,1980,Moscow 1980 | Hungary
Moscow 1980,1,Zimbabwe,1,0,0,1,1980,Moscow 1980 | Zimbabwe
Moscow 1980,1,Democratic People's Republic of Korea,0,3,2,5,1980,Moscow 1980 | Democratic People's Republic of Korea
Lake Placid 1980,0,Sweden,3,0,1,4,1980,Lake Placid 1980 | Sweden
Lake Placid 1980,0,Finland,1,5,3,9,1980,Lake Placid 1980 | Finland
Lake Placid 1980,0,France,0,0,1,1,1980,Lake Placid 1980 | France
Moscow 1980,1,Finland,3,1,4,8,1980,Moscow 1980 | Finland
Lake Placid 1980,0,Soviet Union,10,6,6,22,1980,Lake Placid 1980 | Soviet Union
Lake Placid 1980,0,Japan,0,1,0,1,1980,Lake Placid 1980 | Japan
Lake Placid 1980,0,Czechoslovakia,0,0,1,1,1980,Lake Placid 1980 | Czechoslovakia
Lake Placid 1980,0,Hungary,0,1,0,1,1980,Lake Placid 1980 | Hungary
Moscow 1980,1,Netherlands,0,1,2,3,1980,Moscow 1980 | Netherlands
Lake Placid 1980,0,Federal Republic of Germany,0,2,3,5,1980,Lake Placid 1980 | Federal Republic of Germany
Moscow 1980,1,Belgium,1,0,0,1,1980,Moscow 1980 | Belgium
Moscow 1980,1,Brazil,2,0,2,4,1980,Moscow 1980 | Brazil
Moscow 1980,1,Jamaica,0,0,3,3,1980,Moscow 1980 | Jamaica
Moscow 1980,1,Bulgaria,8,16,17,41,1980,Moscow 1980 | Bulgaria
Lake Placid 1980,0,Liechtenstein,2,2,0,4,1980,Lake Placid 1980 | Liechtenstein
Lake Placid 1980,0,Norway,1,3,6,10,1980,Lake Placid 1980 | Norway
Moscow 1980,1,Soviet Union,80,69,46,195,1980,Moscow 1980 | Soviet Union
Moscow 1980,1,Guyana,0,0,1,1,1980,Moscow 1980 | Guyana
Lake Placid 1980,0,United States of America,6,4,2,12,1980,Lake Placid 1980 | United States of America
Lake Placid 1980,0,Switzerland,1,1,3,5,1980,Lake Placid 1980 | Switzerland
Moscow 1980,1,Denmark,2,1,2,5,1980,Moscow 1980 | Denmark
Moscow 1980,1,Cuba,8,7,5,20,1980,Moscow 1980 | Cuba
Moscow 1980,1,Great Britain,5,7,9,21,1980,Moscow 1980 | Great Britain
Moscow 1980,1,Greece,1,0,2,3,1980,Moscow 1980 | Greece
Lake Placid 1980,0,Great Britain,1,0,0,1,1980,Lake Placid 1980 | Great Britain
Moscow 1980,1,Yugoslavia,2,3,4,9,1980,Moscow 1980 | Yugoslavia
Moscow 1980,1,Australia,2,2,5,9,1980,Moscow 1980 | Australia
Moscow 1980,1,Ethiopia,2,0,2,4,1980,Moscow 1980 | Ethiopia
Moscow 1980,1,Lebanon,0,0,1,1,1980,Moscow 1980 | Lebanon
Moscow 1980,1,Switzerland,2,0,0,2,1980,Moscow 1980 | Switzerland
Moscow 1980,1,Poland,3,14,15,32,1980,Moscow 1980 | Poland
Moscow 1980,1,Austria,1,2,1,4,1980,Moscow 1980 | Austria
Lake Placid 1980,0,German Democratic Republic (Germany),9,7,7,23,1980,Lake Placid 1980 | German Democratic Republic (Germany)
Lake Placid 1980,0,Canada,0,1,1,2,1980,Lake Placid 1980 | Canada
Lake Placid 1980,0,Austria,3,2,2,7,1980,Lake Placid 1980 | Austria
Moscow 1980,1,Italy,8,3,4,15,1980,Moscow 1980 | Italy
Moscow 1980,1,Czechoslovakia,2,3,9,14,1980,Moscow 1980 | Czechoslovakia
Moscow 1980,1,Mongolia,0,2,2,4,1980,Moscow 1980 | Mongolia
Moscow 1980,1,German Democratic Republic (Germany),47,37,42,126,1980,Moscow 1980 | German Democratic Republic (Germany)
Moscow 1980,1,Spain,1,3,2,6,1980,Moscow 1980 | Spain
Moscow 1980,1,Romania,6,6,13,25,1980,Moscow 1980 | Romania
Moscow 1980,1,Ireland,0,1,1,2,1980,Moscow 1980 | Ireland
Moscow 1980,1,Venezuela,0,1,0,1,1980,Moscow 1980 | Venezuela
Moscow 1980,1,France,6,5,3,14,1980,Moscow 1980 | France
Moscow 1980,1,Uganda,0,1,0,1,1980,Moscow 1980 | Uganda
Lake Placid 1980,0,Italy,0,2,0,2,1980,Lake Placid 1980 | Italy
Lake Placid 1980,0,Netherlands,1,2,1,4,1980,Lake Placid 1980 | Netherlands
Moscow 1980,1,United Republic of Tanzania,0,2,0,2,1980,Moscow 1980 | United Republic of Tanzania
Moscow 1980,1,Mexico,0,1,3,4,1980,Moscow 1980 | Mexico
Los Angeles 1984,1,Portugal,1,0,2,3,1984,Los Angeles 1984 | Portugal
Los Angeles 1984,1,Mexico,2,3,1,6,1984,Los Angeles 1984 | Mexico
Los Angeles 1984,1,Dominican Republic,0,0,1,1,1984,Los Angeles 1984 | Dominican Republic
Los Angeles 1984,1,Chinese Taipei,0,0,1,1,1984,Los Angeles 1984 | Chinese Taipei
Los Angeles 1984,1,Ireland,0,1,0,1,1984,Los Angeles 1984 | Ireland
Los Angeles 1984,1,Thailand,0,1,0,1,1984,Los Angeles 1984 | Thailand
Los Angeles 1984,1,Republic of Korea,6,6,7,19,1984,Los Angeles 1984 | Republic of Korea
Los Angeles 1984,1,New Zealand,8,1,2,11,1984,Los Angeles 1984 | New Zealand
Los Angeles 1984,1,United States of America,83,61,30,174,1984,Los Angeles 1984 | United States of America
Sarajevo 1984,0,Canada,2,1,1,4,1984,Sarajevo 1984 | Canada
Sarajevo 1984,0,Federal Republic of Germany,2,1,1,4,1984,Sarajevo 1984 | Federal Republic of Germany
Los Angeles 1984,1,Syrian Arab Republic,0,1,0,1,1984,Los Angeles 1984 | Syrian Arab Republic
Los Angeles 1984,1,Cameroon,0,0,1,1,1984,Los Angeles 1984 | Cameroon
Los Angeles 1984,1,Norway,0,1,2,3,1984,Los Angeles 1984 | Norway
Los Angeles 1984,1,Netherlands,5,2,6,13,1984,Los Angeles 1984 | Netherlands
Los Angeles 1984,1,Romania,20,16,17,53,1984,Los Angeles 1984 | Romania
Los Angeles 1984,1,Turkey,0,0,3,3,1984,Los Angeles 1984 | Turkey
Los Angeles 1984,1,Iceland,0,0,1,1,1984,Los Angeles 1984 | Iceland
Los Angeles 1984,1,Yugoslavia,7,4,7,18,1984,Los Angeles 1984 | Yugoslavia
Los Angeles 1984,1,Zambia,0,0,1,1,1984,Los Angeles 1984 | Zambia
Los Angeles 1984,1,Pakistan,1,0,0,1,1984,Los Angeles 1984 | Pakistan
Los Angeles 1984,1,Federal Republic of Germany,17,19,23,59,1984,Los Angeles 1984 | Federal Republic of Germany
Los Angeles 1984,1,Venezuela,0,0,3,3,1984,Los Angeles 1984 | Venezuela
Los Angeles 1984,1,Côte d'Ivoire,0,1,0,1,1984,Los Angeles 1984 | Côte d'Ivoire
Sarajevo 1984,0,Great Britain,1,0,0,1,1984,Sarajevo 1984 | Great Britain
Los Angeles 1984,1,France,5,7,16,28,1984,Los Angeles 1984 | France
Sarajevo 1984,0,France,0,1,2,3,1984,Sarajevo 1984 | France
Los Angeles 1984,1,Jamaica,0,1,2,3,1984,Los Angeles 1984 | Jamaica
Los Angeles 1984,1,Sweden,2,11,6,19,1984,Los Angeles 1984 | Sweden
Los Angeles 1984,1,Spain,1,2,2,5,1984,Los Angeles 1984 | Spain
Sarajevo 1984,0,Finland,4,3,6,13,1984,Sarajevo 1984 | Finland
Los Angeles 1984,1,Kenya,1,0,2,3,1984,Los Angeles 1984 | Kenya
Los Angeles 1984,1,Egypt,0,1,0,1,1984,Los Angeles 1984 | Egypt
Sarajevo 1984,0,Yugoslavia,0,1,0,1,1984,Sarajevo 1984 | Yugoslavia
Los Angeles 1984,1,Japan,10,8,14,32,1984,Los Angeles 1984 | Japan
Sarajevo 1984,0,Austria,0,0,1,1,1984,Sarajevo 1984 | Austria
Los Angeles 1984,1,Austria,1,1,1,3,1984,Los Angeles 1984 | Austria
Sarajevo 1984,0,Czechoslovakia,0,2,4,6,1984,Sarajevo 1984 | Czechoslovakia
Los Angeles 1984,1,Brazil,1,5,2,8,1984,Los Angeles 1984 | Brazil
Los Angeles 1984,1,Canada,10,18,16,44,1984,Los Angeles 1984 | Canada
Los Angeles 1984,1,Denmark,0,3,3,6,1984,Los Angeles 1984 | Denmark
Sarajevo 1984,0,United States of America,4,4,0,8,1984,Sarajevo 1984 | United States of America
Los Angeles 1984,1,Algeria,0,0,2,2,1984,Los Angeles 1984 | Algeria
Sarajevo 1984,0,Sweden,4,2,2,8,1984,Sarajevo 1984 | Sweden
Sarajevo 1984,0,Liechtenstein,0,0,2,2,1984,Sarajevo 1984 | Liechtenstein
Sarajevo 1984,0,German Democratic Republic (Germany),9,9,6,24,1984,Sarajevo 1984 | German Democratic Republic (Germany)
Sarajevo 1984,0,Japan,0,1,0,1,1984,Sarajevo 1984 | Japan
Los Angeles 1984,1,Finland,4,2,6,12,1984,Los Angeles 1984 | Finland
Los Angeles 1984,1,Australia,4,8,12,24,1984,Los Angeles 1984 | Australia
Los Angeles 1984,1,Belgium,1,1,2,4,1984,Los Angeles 1984 | Belgium
Los Angeles 1984,1,Puerto Rico,0,1,1,2,1984,Los Angeles 1984 | Puerto Rico
Sarajevo 1984,0,Soviet Union,6,10,9,25,1984,Sarajevo 1984 | Soviet Union
Los Angeles 1984,1,People's Republic of China,15,8,9,32,1984,Los Angeles 1984 | People's Republic of China
Sarajevo 1984,0,Norway,3,2,4,9,1984,Sarajevo 1984 | Norway
Sarajevo 1984,0,Italy,2,0,0,2,1984,Sarajevo 1984 | Italy
Los Angeles 1984,1,Greece,0,1,1,2,1984,Los Angeles 1984 | Greece
Sarajevo 1984,0,Switzerland,2,2,1,5,1984,Sarajevo 1984 | Switzerland
Los Angeles 1984,1,Colombia,0,1,0,1,1984,Los Angeles 1984 | Colombia
Los Angeles 1984,1,Switzerland,0,4,4,8,1984,Los Angeles 1984 | Switzerland
Los Angeles 1984,1,Nigeria,0,1,1,2,1984,Los Angeles 1984 | Nigeria
Los Angeles 1984,1,Italy,14,6,12,32,1984,Los Angeles 1984 | Italy
Los Angeles 1984,1,Peru,0,1,0,1,1984,Los Angeles 1984 | Peru
Los Angeles 1984,1,Great Britain,5,11,21,37,1984,Los Angeles 1984 | Great Britain
Los Angeles 1984,1,Morocco,2,0,0,2,1984,Los Angeles 1984 | Morocco
Seoul 1988,1,Suriname,1,0,0,1,1988,Seoul 1988 | Suriname
Seoul 1988,1,Morocco,1,0,2,3,1988,Seoul 1988 | Morocco
Seoul 1988,1,German Democratic Republic (Germany),37,35,30,102,1988,Seoul 1988 | German Democratic Republic (Germany)
Seoul 1988,1,New Zealand,3,2,8,13,1988,Seoul 1988 | New Zealand
Calgary 1988,0,Canada,0,2,3,5,1988,Calgary 1988 | Canada
Calgary 1988,0,Switzerland,5,5,5,15,1988,Calgary 1988 | Switzerland
Seoul 1988,1,Colombia,0,0,1,1,1988,Seoul 1988 | Colombia
Seoul 1988,1,Philippines,0,0,1,1,1988,Seoul 1988 | Philippines
Seoul 1988,1,Finland,1,1,2,4,1988,Seoul 1988 | Finland
Seoul 1988,1,France,6,4,6,16,1988,Seoul 1988 | France
Seoul 1988,1,Italy,6,4,4,14,1988,Seoul 1988 | Italy
Seoul 1988,1,Costa Rica,0,1,0,1,1988,Seoul 1988 | Costa Rica
Seoul 1988,1,Switzerland,0,2,2,4,1988,Seoul 1988 | Switzerland
Seoul 1988,1,Poland,2,5,9,16,1988,Seoul 1988 | Poland
Seoul 1988,1,Federal Republic of Germany,11,14,15,40,1988,Seoul 1988 | Federal Republic of Germany
Seoul 1988,1,Japan,4,3,7,14,1988,Seoul 1988 | Japan
Seoul 1988,1,Peru,0,1,0,1,1988,Seoul 1988 | Peru
Seoul 1988,1,Austria,1,0,0,1,1988,Seoul 1988 | Austria
Seoul 1988,1,Australia,3,6,5,14,1988,Seoul 1988 | Australia
Calgary 1988,0,Japan,0,0,1,1,1988,Calgary 1988 | Japan
Seoul 1988,1,Pakistan,0,0,1,1,1988,Seoul 1988 | Pakistan
Seoul 1988,1,Thailand,0,0,1,1,1988,Seoul 1988 | Thailand
Calgary 1988,0,Yugoslavia,0,2,1,3,1988,Calgary 1988 | Yugoslavia
Calgary 1988,0,Liechtenstein,0,0,1,1,1988,Calgary 1988 | Liechtenstein
Seoul 1988,1,Djibouti,0,0,1,1,1988,Seoul 1988 | Djibouti
Seoul 1988,1,Spain,1,1,2,4,1988,Seoul 1988 | Spain
Seoul 1988,1,Greece,0,0,1,1,1988,Seoul 1988 | Greece
Seoul 1988,1,Yugoslavia,3,4,5,12,1988,Seoul 1988 | Yugoslavia
Seoul 1988,1,Portugal,1,0,0,1,1988,Seoul 1988 | Portugal
Seoul 1988,1,Denmark,2,1,1,4,1988,Seoul 1988 | Denmark
Seoul 1988,1,Mongolia,0,0,1,1,1988,Seoul 1988 | Mongolia
Seoul 1988,1,Jamaica,0,2,0,2,1988,Seoul 1988 | Jamaica
Seoul 1988,1,Netherlands Antilles,0,1,0,1,1988,Seoul 1988 | Netherlands Antilles
Seoul 1988,1,Republic of Korea,12,10,11,33,1988,Seoul 1988 | Republic of Korea
Seoul 1988,1,Norway,2,3,0,5,1988,Seoul 1988 | Norway
Seoul 1988,1,Netherlands,2,2,5,9,1988,Seoul 1988 | Netherlands
Seoul 1988,1,Belgium,0,0,2,2,1988,Seoul 1988 | Belgium
Seoul 1988,1,Mexico,0,0,2,2,1988,Seoul 1988 | Mexico
Seoul 1988,1,United States of America,36,31,27,94,1988,Seoul 1988 | United States of America
Seoul 1988,1,Czechoslovakia,3,3,2,8,1988,Seoul 1988 | Czechoslovakia
Calgary 1988,0,Federal Republic of Germany,2,4,2,8,1988,Calgary 1988 | Federal Republic of Germany
Seoul 1988,1,Indonesia,0,1,0,1,1988,Seoul 1988 | Indonesia
Seoul 1988,1,Brazil,1,2,3,6,1988,Seoul 1988 | Brazil
Seoul 1988,1,Hungary,11,6,6,23,1988,Seoul 1988 | Hungary
Calgary 1988,0,Italy,2,1,2,5,1988,Calgary 1988 | Italy
Seoul 1988,1,Turkey,1,1,0,2,1988,Seoul 1988 | Turkey
Seoul 1988,1,Romania,7,11,6,24,1988,Seoul 1988 | Romania
Calgary 1988,0,Soviet Union,11,9,9,29,1988,Calgary 1988 | Soviet Union
Calgary 1988,0,United States of America,2,1,3,6,1988,Calgary 1988 | United States of America
Seoul 1988,1,Soviet Union,55,31,46,132,1988,Seoul 1988 | Soviet Union
Seoul 1988,1,Argentina,0,1,1,2,1988,Seoul 1988 | Argentina
Calgary 1988,0,France,1,0,1,2,1988,Calgary 1988 | France
Calgary 1988,0,Finland,4,1,2,7,1988,Calgary 1988 | Finland
Calgary 1988,0,German Democratic Republic (Germany),9,10,6,25,1988,Calgary 1988 | German Democratic Republic (Germany)
Calgary 1988,0,Netherlands,3,2,2,7,1988,Calgary 1988 | Netherlands
Seoul 1988,1,People's Republic of China,5,11,12,28,1988,Seoul 1988 | People's Republic of China
Calgary 1988,0,Sweden,4,0,2,6,1988,Calgary 1988 | Sweden
Seoul 1988,1,Great Britain,5,10,9,24,1988,Seoul 1988 | Great Britain
Seoul 1988,1,Kenya,5,2,2,9,1988,Seoul 1988 | Kenya
Calgary 1988,0,Norway,0,3,2,5,1988,Calgary 1988 | Norway
Seoul 1988,1,Bulgaria,10,12,13,35,1988,Seoul 1988 | Bulgaria
Seoul 1988,1,"Virgin Islands, US",0,1,0,1,1988,"Seoul 1988 | Virgin Islands, US"
Seoul 1988,1,Canada,3,2,5,10,1988,Seoul 1988 | Canada
Calgary 1988,0,Czechoslovakia,0,1,2,3,1988,Calgary 1988 | Czechoslovakia
Seoul 1988,1,Senegal,0,1,0,1,1988,Seoul 1988 | Senegal
Calgary 1988,0,Austria,3,5,2,10,1988,Calgary 1988 | Austria
Seoul 1988,1,Chile,0,1,0,1,1988,Seoul 1988 | Chile
Seoul 1988,1,Sweden,0,4,7,11,1988,Seoul 1988 | Sweden
Seoul 1988,1,Islamic Republic of Iran,0,1,0,1,1988,Seoul 1988 | Islamic Republic of Iran
Barcelona 1992,1,Turkey,2,2,2,6,1992,Barcelona 1992 | Turkey
Albertville 1992,0,Sweden,1,0,3,4,1992,Albertville 1992 | Sweden
Barcelona 1992,1,Pakistan,0,0,1,1,1992,Barcelona 1992 | Pakistan
Barcelona 1992,1,Suriname,0,0,1,1,1992,Barcelona 1992 | Suriname
Albertville 1992,0,Democratic People's Republic of Korea,0,0,1,1,1992,Albertville 1992 | Democratic People's Republic of Korea
Barcelona 1992,1,People's Republic of China,16,22,16,54,1992,Barcelona 1992 | People's Republic of China
Barcelona 1992,1,Estonia,1,0,1,2,1992,Barcelona 1992 | Estonia
Albertville 1992,0,Spain,0,0,1,1,1992,Albertville 1992 | Spain
Barcelona 1992,1,Algeria,1,0,1,2,1992,Barcelona 1992 | Algeria
Barcelona 1992,1,France,8,5,16,29,1992,Barcelona 1992 | France
Barcelona 1992,1,Islamic Republic of Iran,0,1,2,3,1992,Barcelona 1992 | Islamic Republic of Iran
Barcelona 1992,1,Belgium,0,1,2,3,1992,Barcelona 1992 | Belgium
Albertville 1992,0,Netherlands,1,1,2,4,1992,Albertville 1992 | Netherlands
Barcelona 1992,1,Lithuania,1,0,1,2,1992,Barcelona 1992 | Lithuania
Barcelona 1992,1,Bulgaria,3,7,6,16,1992,Barcelona 1992 | Bulgaria
Barcelona 1992,1,Czechoslovakia,4,2,1,7,1992,Barcelona 1992 | Czechoslovakia
Barcelona 1992,1,Argentina,0,0,1,1,1992,Barcelona 1992 | Argentina
Barcelona 1992,1,United States of America,37,34,37,108,1992,Barcelona 1992 | United States of America
Barcelona 1992,1,Philippines,0,0,1,1,1992,Barcelona 1992 | Philippines
Barcelona 1992,1,South Africa,0,2,0,2,1992,Barcelona 1992 | South Africa
Barcelona 1992,1,Brazil,2,1,0,3,1992,Barcelona 1992 | Brazil
Albertville 1992,0,Japan,1,2,4,7,1992,Albertville 1992 | Japan
Barcelona 1992,1,Austria,0,2,0,2,1992,Barcelona 1992 | Austria
Barcelona 1992,1,Netherlands,2,6,7,15,1992,Barcelona 1992 | Netherlands
Barcelona 1992,1,Australia,7,9,11,27,1992,Barcelona 1992 | Australia
Barcelona 1992,1,Bahamas,0,0,1,1,1992,Barcelona 1992 | Bahamas
Barcelona 1992,1,Namibia,0,2,0,2,1992,Barcelona 1992 | Namibia
Barcelona 1992,1,Colombia,0,0,1,1,1992,Barcelona 1992 | Colombia
Albertville 1992,0,Germany,10,10,6,26,1992,Albertville 1992 | Germany
Albertville 1992,0,Italy,4,6,4,14,1992,Albertville 1992 | Italy
Barcelona 1992,1,Romania,4,6,8,18,1992,Barcelona 1992 | Romania
Barcelona 1992,1,Thailand,0,0,1,1,1992,Barcelona 1992 | Thailand
Barcelona 1992,1,Ghana,0,0,1,1,1992,Barcelona 1992 | Ghana
Albertville 1992,0,Canada,2,3,2,7,1992,Albertville 1992 | Canada
Barcelona 1992,1,Norway,2,4,1,7,1992,Barcelona 1992 | Norway
Albertville 1992,0,Finland,3,1,3,7,1992,Albertville 1992 | Finland
Barcelona 1992,1,Nigeria,0,3,1,4,1992,Barcelona 1992 | Nigeria
Barcelona 1992,1,Jamaica,0,3,1,4,1992,Barcelona 1992 | Jamaica
Barcelona 1992,1,Puerto Rico,0,0,1,1,1992,Barcelona 1992 | Puerto Rico
Barcelona 1992,1,Malaysia,0,0,1,1,1992,Barcelona 1992 | Malaysia
Barcelona 1992,1,Croatia,0,1,2,3,1992,Barcelona 1992 | Croatia
Barcelona 1992,1,Qatar,0,0,1,1,1992,Barcelona 1992 | Qatar
Barcelona 1992,1,Israel,0,1,1,2,1992,Barcelona 1992 | Israel
Barcelona 1992,1,Greece,2,0,0,2,1992,Barcelona 1992 | Greece
Albertville 1992,0,United States of America,5,4,2,11,1992,Albertville 1992 | United States of America
Barcelona 1992,1,Sweden,1,7,4,12,1992,Barcelona 1992 | Sweden
Albertville 1992,0,Austria,6,7,8,21,1992,Albertville 1992 | Austria
Barcelona 1992,1,Indonesia,2,2,1,5,1992,Barcelona 1992 | Indonesia
Albertville 1992,0,Norway,9,6,5,20,1992,Albertville 1992 | Norway
Albertville 1992,0,Republic of Korea,2,1,1,4,1992,Albertville 1992 | Republic of Korea
Barcelona 1992,1,Switzerland,1,0,0,1,1992,Barcelona 1992 | Switzerland
Barcelona 1992,1,Great Britain,5,3,12,20,1992,Barcelona 1992 | Great Britain
Barcelona 1992,1,Germany,33,21,28,82,1992,Barcelona 1992 | Germany
Albertville 1992,0,France,3,5,1,9,1992,Albertville 1992 | France
Barcelona 1992,1,Chinese Taipei,0,1,0,1,1992,Barcelona 1992 | Chinese Taipei
Barcelona 1992,1,Democratic People's Republic of Korea,4,0,5,9,1992,Barcelona 1992 | Democratic People's Republic of Korea
Barcelona 1992,1,Italy,6,5,8,19,1992,Barcelona 1992 | Italy
Barcelona 1992,1,Poland,3,6,10,19,1992,Barcelona 1992 | Poland
Barcelona 1992,1,Mexico,0,1,0,1,1992,Barcelona 1992 | Mexico
Barcelona 1992,1,New Zealand,1,4,5,10,1992,Barcelona 1992 | New Zealand
Barcelona 1992,1,Peru,0,1,0,1,1992,Barcelona 1992 | Peru
Albertville 1992,0,Switzerland,1,0,2,3,1992,Albertville 1992 | Switzerland
Barcelona 1992,1,Ethiopia,1,0,2,3,1992,Barcelona 1992 | Ethiopia
Barcelona 1992,1,Independent Olympic Athletes,0,1,2,3,1992,Barcelona 1992 | Independent Olympic Athletes
Barcelona 1992,1,Finland,1,2,2,5,1992,Barcelona 1992 | Finland
Barcelona 1992,1,Kenya,2,4,2,8,1992,Barcelona 1992 | Kenya
Barcelona 1992,1,Denmark,1,1,4,6,1992,Barcelona 1992 | Denmark
Barcelona 1992,1,Ireland,1,1,0,2,1992,Barcelona 1992 | Ireland
Albertville 1992,0,Unified Team,9,6,8,23,1992,Albertville 1992 | Unified Team
Barcelona 1992,1,Spain,13,7,2,22,1992,Barcelona 1992 | Spain
Barcelona 1992,1,Canada,7,4,7,18,1992,Barcelona 1992 | Canada
Barcelona 1992,1,Japan,3,8,11,22,1992,Barcelona 1992 | Japan
Barcelona 1992,1,Republic of Korea,12,5,12,29,1992,Barcelona 1992 | Republic of Korea
Albertville 1992,0,New Zealand,0,1,0,1,1992,Albertville 1992 | New Zealand
Barcelona 1992,1,Unified Team,45,38,29,112,1992,Barcelona 1992 | Unified Team
Barcelona 1992,1,Latvia,0,2,1,3,1992,Barcelona 1992 | Latvia
Barcelona 1992,1,Hungary,11,12,7,30,1992,Barcelona 1992 | Hungary
Albertville 1992,0,Czechoslovakia,0,0,3,3,1992,Albertville 1992 | Czechoslovakia
Barcelona 1992,1,Morocco,1,1,1,3,1992,Barcelona 1992 | Morocco
Barcelona 1992,1,Cuba,14,6,11,31,1992,Barcelona 1992 | Cuba
Barcelona 1992,1,Mongolia,0,0,2,2,1992,Barcelona 1992 | Mongolia
Albertville 1992,0,Luxembourg,0,2,0,2,1992,Albertville 1992 | Luxembourg
Barcelona 1992,1,Slovenia,0,0,2,2,1992,Barcelona 1992 | Slovenia
Albertville 1992,0,People's Republic of China,0,3,0,3,1992,Albertville 1992 | People's Republic of China
Lillehammer 1994,0,Australia,0,0,1,1,1994,Lillehammer 1994 | Australia
Lillehammer 1994,0,Sweden,2,1,0,3,1994,Lillehammer 1994 | Sweden
Lillehammer 1994,0,Great Britain,0,0,2,2,1994,Lillehammer 1994 | Great Britain
Lillehammer 1994,0,Belarus,0,2,0,2,1994,Lillehammer 1994 | Belarus
Lillehammer 1994,0,Kazakhstan,1,2,0,3,1994,Lillehammer 1994 | Kazakhstan
Lillehammer 1994,0,Slovenia,0,0,3,3,1994,Lillehammer 1994 | Slovenia
Lillehammer 1994,0,Ukraine,1,0,1,2,1994,Lillehammer 1994 | Ukraine
Lillehammer 1994,0,Uzbekistan,1,0,0,1,1994,Lillehammer 1994 | Uzbekistan
Lillehammer 1994,0,People's Republic of China,0,1,2,3,1994,Lillehammer 1994 | People's Republic of China
Lillehammer 1994,0,France,0,1,4,5,1994,Lillehammer 1994 | France
Lillehammer 1994,0,Japan,1,2,2,5,1994,Lillehammer 1994 | Japan
Lillehammer 1994,0,Germany,9,7,8,24,1994,Lillehammer 1994 | Germany
Lillehammer 1994,0,Russian Federation,11,8,4,23,1994,Lillehammer 1994 | Russian Federation
Lillehammer 1994,0,United States of America,6,5,2,13,1994,Lillehammer 1994 | United States of America
Lillehammer 1994,0,Norway,10,11,5,26,1994,Lillehammer 1994 | Norway
Lillehammer 1994,0,Republic of Korea,4,1,1,6,1994,Lillehammer 1994 | Republic of Korea
Lillehammer 1994,0,Netherlands,0,1,3,4,1994,Lillehammer 1994 | Netherlands
Lillehammer 1994,0,Italy,7,5,8,20,1994,Lillehammer 1994 | Italy
Lillehammer 1994,0,Canada,3,6,4,13,1994,Lillehammer 1994 | Canada
Lillehammer 1994,0,Switzerland,3,4,2,9,1994,Lillehammer 1994 | Switzerland
Lillehammer 1994,0,Austria,2,3,4,9,1994,Lillehammer 1994 | Austria
Lillehammer 1994,0,Finland,0,1,5,6,1994,Lillehammer 1994 | Finland
Atlanta 1996,1,Kenya,1,4,3,8,1996,Atlanta 1996 | Kenya
Atlanta 1996,1,Bahamas,0,1,0,1,1996,Atlanta 1996 | Bahamas
Atlanta 1996,1,Hungary,7,4,10,21,1996,Atlanta 1996 | Hungary
Atlanta 1996,1,India,0,0,1,1,1996,Atlanta 1996 | India
Atlanta 1996,1,Tunisia,0,0,1,1,1996,Atlanta 1996 | Tunisia
Atlanta 1996,1,Philippines,0,1,0,1,1996,Atlanta 1996 | Philippines
Atlanta 1996,1,Bulgaria,3,7,5,15,1996,Atlanta 1996 | Bulgaria
Atlanta 1996,1,"Hong Kong, China",1,0,0,1,1996,"Atlanta 1996 | Hong Kong, China"
Atlanta 1996,1,Syrian Arab Republic,1,0,0,1,1996,Atlanta 1996 | Syrian Arab Republic
Atlanta 1996,1,Denmark,4,1,1,6,1996,Atlanta 1996 | Denmark
Atlanta 1996,1,Slovenia,0,2,0,2,1996,Atlanta 1996 | Slovenia
Atlanta 1996,1,Namibia,0,2,0,2,1996,Atlanta 1996 | Namibia
Atlanta 1996,1,Spain,5,6,6,17,1996,Atlanta 1996 | Spain
Atlanta 1996,1,Slovakia,1,1,1,3,1996,Atlanta 1996 | Slovakia
Atlanta 1996,1,Islamic Republic of Iran,1,1,1,3,1996,Atlanta 1996 | Islamic Republic of Iran
Atlanta 1996,1,Mongolia,0,0,1,1,1996,Atlanta 1996 | Mongolia
Atlanta 1996,1,Turkey,4,1,1,6,1996,Atlanta 1996 | Turkey
Atlanta 1996,1,Jamaica,1,3,2,6,1996,Atlanta 1996 | Jamaica
Atlanta 1996,1,Ukraine,9,2,12,23,1996,Atlanta 1996 | Ukraine
Atlanta 1996,1,Argentina,0,2,1,3,1996,Atlanta 1996 | Argentina
Atlanta 1996,1,Thailand,1,0,1,2,1996,Atlanta 1996 | Thailand
Atlanta 1996,1,Cuba,9,8,8,25,1996,Atlanta 1996 | Cuba
Atlanta 1996,1,Germany,20,18,27,65,1996,Atlanta 1996 | Germany
Atlanta 1996,1,Netherlands,4,5,10,19,1996,Atlanta 1996 | Netherlands
Atlanta 1996,1,Russian Federation,26,21,16,63,1996,Atlanta 1996 | Russian Federation
Atlanta 1996,1,Belgium,2,2,2,6,1996,Atlanta 1996 | Belgium
Atlanta 1996,1,Ireland,3,0,1,4,1996,Atlanta 1996 | Ireland
Atlanta 1996,1,Czech Republic,4,3,4,11,1996,Atlanta 1996 | Czech Republic
Atlanta 1996,1,Nigeria,2,1,3,6,1996,Atlanta 1996 | Nigeria
Atlanta 1996,1,People's Republic of China,16,22,12,50,1996,Atlanta 1996 | People's Republic of China
Atlanta 1996,1,New Zealand,3,2,1,6,1996,Atlanta 1996 | New Zealand
Atlanta 1996,1,Georgia,0,0,2,2,1996,Atlanta 1996 | Georgia
Atlanta 1996,1,Morocco,0,0,2,2,1996,Atlanta 1996 | Morocco
Atlanta 1996,1,Trinidad and Tobago,0,0,2,2,1996,Atlanta 1996 | Trinidad and Tobago
Atlanta 1996,1,Kazakhstan,3,4,4,11,1996,Atlanta 1996 | Kazakhstan
Atlanta 1996,1,Azerbaijan,0,1,0,1,1996,Atlanta 1996 | Azerbaijan
Atlanta 1996,1,Chinese Taipei,0,1,0,1,1996,Atlanta 1996 | Chinese Taipei
Atlanta 1996,1,Republic of Korea,7,15,5,27,1996,Atlanta 1996 | Republic of Korea
Atlanta 1996,1,Tonga,0,1,0,1,1996,Atlanta 1996 | Tonga
Atlanta 1996,1,Zambia,0,1,0,1,1996,Atlanta 1996 | Zambia
Atlanta 1996,1,Latvia,0,1,0,1,1996,Atlanta 1996 | Latvia
Atlanta 1996,1,Finland,1,2,1,4,1996,Atlanta 1996 | Finland
Atlanta 1996,1,Malaysia,0,1,1,2,1996,Atlanta 1996 | Malaysia
Atlanta 1996,1,Republic of Moldova,0,1,1,2,1996,Atlanta 1996 | Republic of Moldova
Atlanta 1996,1,Uzbekistan,0,1,1,2,1996,Atlanta 1996 | Uzbekistan
Atlanta 1996,1,South Africa,3,1,1,5,1996,Atlanta 1996 | South Africa
Atlanta 1996,1,Ethiopia,2,0,1,3,1996,Atlanta 1996 | Ethiopia
Atlanta 1996,1,Algeria,2,0,1,3,1996,Atlanta 1996 | Algeria
Atlanta 1996,1,Puerto Rico,0,0,1,1,1996,Atlanta 1996 | Puerto Rico
Atlanta 1996,1,Uganda,0,0,1,1,1996,Atlanta 1996 | Uganda
Atlanta 1996,1,Sweden,2,4,2,8,1996,Atlanta 1996 | Sweden
Atlanta 1996,1,Mozambique,0,0,1,1,1996,Atlanta 1996 | Mozambique
Atlanta 1996,1,Mexico,0,0,1,1,1996,Atlanta 1996 | Mexico
Atlanta 1996,1,Romania,4,7,9,20,1996,Atlanta 1996 | Romania
Atlanta 1996,1,Japan,3,6,5,14,1996,Atlanta 1996 | Japan
Atlanta 1996,1,Italy,13,10,12,35,1996,Atlanta 1996 | Italy
Atlanta 1996,1,Democratic People's Republic of Korea,2,1,2,5,1996,Atlanta 1996 | Democratic People's Republic of Korea
Atlanta 1996,1,United States of America,44,32,25,101,1996,Atlanta 1996 | United States of America
Atlanta 1996,1,France,15,7,15,37,1996,Atlanta 1996 | France
Atlanta 1996,1,Israel,0,0,1,1,1996,Atlanta 1996 | Israel
Atlanta 1996,1,Burundi,1,0,0,1,1996,Atlanta 1996 | Burundi
Atlanta 1996,1,Canada,3,11,8,22,1996,Atlanta 1996 | Canada
Atlanta 1996,1,Serbia and Montenegro,1,1,2,4,1996,Atlanta 1996 | Serbia and Montenegro
Atlanta 1996,1,Indonesia,1,1,2,4,1996,Atlanta 1996 | Indonesia
Atlanta 1996,1,Brazil,3,3,9,15,1996,Atlanta 1996 | Brazil
Atlanta 1996,1,Greece,4,4,0,8,1996,Atlanta 1996 | Greece
Atlanta 1996,1,Costa Rica,1,0,0,1,1996,Atlanta 1996 | Costa Rica
Atlanta 1996,1,Poland,7,5,5,17,1996,Atlanta 1996 | Poland
Atlanta 1996,1,Croatia,1,1,0,2,1996,Atlanta 1996 | Croatia
Atlanta 1996,1,Great Britain,1,8,6,15,1996,Atlanta 1996 | Great Britain
Atlanta 1996,1,Ecuador,1,0,0,1,1996,Atlanta 1996 | Ecuador
Atlanta 1996,1,Lithuania,0,0,1,1,1996,Atlanta 1996 | Lithuania
Atlanta 1996,1,Norway,2,2,3,7,1996,Atlanta 1996 | Norway
Atlanta 1996,1,Australia,9,9,23,41,1996,Atlanta 1996 | Australia
Atlanta 1996,1,Belarus,1,6,8,15,1996,Atlanta 1996 | Belarus
Atlanta 1996,1,Austria,0,1,2,3,1996,Atlanta 1996 | Austria
Atlanta 1996,1,Switzerland,4,3,0,7,1996,Atlanta 1996 | Switzerland
Atlanta 1996,1,Armenia,1,1,0,2,1996,Atlanta 1996 | Armenia
Atlanta 1996,1,Portugal,1,0,1,2,1996,Atlanta 1996 | Portugal
Nagano 1998,0,Austria,3,5,9,17,1998,Nagano 1998 | Austria
Nagano 1998,0,Japan,5,1,4,10,1998,Nagano 1998 | Japan
Nagano 1998,0,Russian Federation,9,6,3,18,1998,Nagano 1998 | Russian Federation
Nagano 1998,0,Italy,2,6,2,10,1998,Nagano 1998 | Italy
Nagano 1998,0,Finland,2,4,6,12,1998,Nagano 1998 | Finland
Nagano 1998,0,Belgium,0,0,1,1,1998,Nagano 1998 | Belgium
Nagano 1998,0,Canada,6,5,4,15,1998,Nagano 1998 | Canada
Nagano 1998,0,Great Britain,0,0,1,1,1998,Nagano 1998 | Great Britain
Nagano 1998,0,Switzerland,2,2,3,7,1998,Nagano 1998 | Switzerland
Nagano 1998,0,Sweden,0,2,1,3,1998,Nagano 1998 | Sweden
Nagano 1998,0,Denmark,0,1,0,1,1998,Nagano 1998 | Denmark
Nagano 1998,0,Ukraine,0,1,0,1,1998,Nagano 1998 | Ukraine
Nagano 1998,0,Czech Republic,1,1,1,3,1998,Nagano 1998 | Czech Republic
Nagano 1998,0,Germany,12,9,8,29,1998,Nagano 1998 | Germany
Nagano 1998,0,Bulgaria,1,0,0,1,1998,Nagano 1998 | Bulgaria
Nagano 1998,0,Norway,10,10,5,25,1998,Nagano 1998 | Norway
Nagano 1998,0,Australia,0,0,1,1,1998,Nagano 1998 | Australia
Nagano 1998,0,Republic of Korea,3,1,2,6,1998,Nagano 1998 | Republic of Korea
Nagano 1998,0,Netherlands,5,4,2,11,1998,Nagano 1998 | Netherlands
Nagano 1998,0,People's Republic of China,0,6,2,8,1998,Nagano 1998 | People's Republic of China
Nagano 1998,0,Belarus,0,0,2,2,1998,Nagano 1998 | Belarus
Nagano 1998,0,France,2,1,5,8,1998,Nagano 1998 | France
Nagano 1998,0,United States of America,6,3,4,13,1998,Nagano 1998 | United States of America
Nagano 1998,0,Kazakhstan,0,0,2,2,1998,Nagano 1998 | Kazakhstan
Sydney 2000,1,Republic of Moldova,0,1,1,2,2000,Sydney 2000 | Republic of Moldova
Sydney 2000,1,Georgia,0,0,6,6,2000,Sydney 2000 | Georgia
Sydney 2000,1,Trinidad and Tobago,0,1,1,2,2000,Sydney 2000 | Trinidad and Tobago
Sydney 2000,1,Slovakia,1,3,1,5,2000,Sydney 2000 | Slovakia
Sydney 2000,1,Saudi Arabia,0,1,1,2,2000,Sydney 2000 | Saudi Arabia
Sydney 2000,1,Bulgaria,5,6,2,13,2000,Sydney 2000 | Bulgaria
Sydney 2000,1,Canada,3,3,8,14,2000,Sydney 2000 | Canada
Sydney 2000,1,Lithuania,2,0,3,5,2000,Sydney 2000 | Lithuania
Sydney 2000,1,Sweden,4,5,3,12,2000,Sydney 2000 | Sweden
Sydney 2000,1,Russian Federation,32,28,29,89,2000,Sydney 2000 | Russian Federation
Sydney 2000,1,Slovenia,2,0,0,2,2000,Sydney 2000 | Slovenia
Sydney 2000,1,Italy,13,8,13,34,2000,Sydney 2000 | Italy
Sydney 2000,1,Turkey,3,0,2,5,2000,Sydney 2000 | Turkey
Sydney 2000,1,Czech Republic,2,3,3,8,2000,Sydney 2000 | Czech Republic
Sydney 2000,1,Hungary,8,6,3,17,2000,Sydney 2000 | Hungary
Sydney 2000,1,Croatia,1,0,1,2,2000,Sydney 2000 | Croatia
Sydney 2000,1,Greece,4,6,3,13,2000,Sydney 2000 | Greece
Sydney 2000,1,Belarus,3,3,11,17,2000,Sydney 2000 | Belarus
Sydney 2000,1,Denmark,2,3,1,6,2000,Sydney 2000 | Denmark
Sydney 2000,1,Costa Rica,0,0,2,2,2000,Sydney 2000 | Costa Rica
Sydney 2000,1,Portugal,0,0,2,2,2000,Sydney 2000 | Portugal
Sydney 2000,1,People's Republic of China,28,16,14,58,2000,Sydney 2000 | People's Republic of China
Sydney 2000,1,Australia,16,25,17,58,2000,Sydney 2000 | Australia
Sydney 2000,1,United States of America,37,24,32,93,2000,Sydney 2000 | United States of America
Sydney 2000,1,Poland,6,5,3,14,2000,Sydney 2000 | Poland
Sydney 2000,1,Germany,13,17,26,56,2000,Sydney 2000 | Germany
Sydney 2000,1,Jamaica,0,6,3,9,2000,Sydney 2000 | Jamaica
Sydney 2000,1,Cuba,11,11,7,29,2000,Sydney 2000 | Cuba
Sydney 2000,1,Ethiopia,4,1,3,8,2000,Sydney 2000 | Ethiopia
Sydney 2000,1,Indonesia,1,3,2,6,2000,Sydney 2000 | Indonesia
Sydney 2000,1,Great Britain,11,10,7,28,2000,Sydney 2000 | Great Britain
Sydney 2000,1,Kenya,2,3,2,7,2000,Sydney 2000 | Kenya
Sydney 2000,1,France,13,14,11,38,2000,Sydney 2000 | France
Sydney 2000,1,Switzerland,1,6,2,9,2000,Sydney 2000 | Switzerland
Sydney 2000,1,Mexico,1,2,3,6,2000,Sydney 2000 | Mexico
Sydney 2000,1,Kazakhstan,3,4,0,7,2000,Sydney 2000 | Kazakhstan
Sydney 2000,1,Azerbaijan,2,0,1,3,2000,Sydney 2000 | Azerbaijan
Sydney 2000,1,Colombia,1,0,0,1,2000,Sydney 2000 | Colombia
Sydney 2000,1,New Zealand,1,0,3,4,2000,Sydney 2000 | New Zealand
Sydney 2000,1,Estonia,1,0,2,3,2000,Sydney 2000 | Estonia
Sydney 2000,1,Kyrgyzstan,0,0,1,1,2000,Sydney 2000 | Kyrgyzstan
Sydney 2000,1,Bahamas,2,0,1,3,2000,Sydney 2000 | Bahamas
Sydney 2000,1,Uzbekistan,1,1,2,4,2000,Sydney 2000 | Uzbekistan
Sydney 2000,1,Cameroon,1,0,0,1,2000,Sydney 2000 | Cameroon
Sydney 2000,1,Armenia,0,0,1,1,2000,Sydney 2000 | Armenia
Sydney 2000,1,Kuwait,0,0,1,1,2000,Sydney 2000 | Kuwait
Sydney 2000,1,North Macedonia,0,0,1,1,2000,Sydney 2000 | North Macedonia
Sydney 2000,1,Mozambique,1,0,0,1,2000,Sydney 2000 | Mozambique
Sydney 2000,1,Ireland,0,1,0,1,2000,Sydney 2000 | Ireland
Sydney 2000,1,Romania,11,6,9,26,2000,Sydney 2000 | Romania
Sydney 2000,1,Barbados,0,0,1,1,2000,Sydney 2000 | Barbados
Sydney 2000,1,Qatar,0,0,1,1,2000,Sydney 2000 | Qatar
Sydney 2000,1,South Africa,0,2,3,5,2000,Sydney 2000 | South Africa
Sydney 2000,1,Belgium,0,2,3,5,2000,Sydney 2000 | Belgium
Sydney 2000,1,Finland,2,1,1,4,2000,Sydney 2000 | Finland
Sydney 2000,1,Norway,4,3,3,10,2000,Sydney 2000 | Norway
Sydney 2000,1,Chile,0,0,1,1,2000,Sydney 2000 | Chile
Sydney 2000,1,Japan,5,8,5,18,2000,Sydney 2000 | Japan
Sydney 2000,1,Uruguay,0,1,0,1,2000,Sydney 2000 | Uruguay
Sydney 2000,1,Thailand,1,0,2,3,2000,Sydney 2000 | Thailand
Sydney 2000,1,Serbia and Montenegro,1,1,1,3,2000,Sydney 2000 | Serbia and Montenegro
Sydney 2000,1,Algeria,1,1,3,5,2000,Sydney 2000 | Algeria
Sydney 2000,1,Ukraine,3,10,10,23,2000,Sydney 2000 | Ukraine
Sydney 2000,1,Nigeria,1,2,0,3,2000,Sydney 2000 | Nigeria
Sydney 2000,1,Democratic People's Republic of Korea,0,1,3,4,2000,Sydney 2000 | Democratic People's Republic of Korea
Sydney 2000,1,Islamic Republic of Iran,3,0,1,4,2000,Sydney 2000 | Islamic Republic of Iran
Sydney 2000,1,Austria,2,1,0,3,2000,Sydney 2000 | Austria
Sydney 2000,1,Chinese Taipei,0,1,4,5,2000,Sydney 2000 | Chinese Taipei
Sydney 2000,1,Republic of Korea,8,10,10,28,2000,Sydney 2000 | Republic of Korea
Sydney 2000,1,Vietnam,0,1,0,1,2000,Sydney 2000 | Vietnam
Sydney 2000,1,Israel,0,0,1,1,2000,Sydney 2000 | Israel
Sydney 2000,1,Iceland,0,0,1,1,2000,Sydney 2000 | Iceland
Sydney 2000,1,India,0,0,1,1,2000,Sydney 2000 | India
Sydney 2000,1,Spain,3,3,5,11,2000,Sydney 2000 | Spain
Sydney 2000,1,Sri Lanka,0,1,0,1,2000,Sydney 2000 | Sri Lanka
Sydney 2000,1,Latvia,1,1,1,3,2000,Sydney 2000 | Latvia
Sydney 2000,1,Brazil,0,6,6,12,2000,Sydney 2000 | Brazil
Sydney 2000,1,Netherlands,12,9,4,25,2000,Sydney 2000 | Netherlands
Sydney 2000,1,Argentina,0,2,2,4,2000,Sydney 2000 | Argentina
Sydney 2000,1,Morocco,0,1,4,5,2000,Sydney 2000 | Morocco
Salt Lake City 2002,0,Russian Federation,5,4,4,13,2002,Salt Lake City 2002 | Russian Federation
Salt Lake City 2002,0,Slovenia,0,0,1,1,2002,Salt Lake City 2002 | Slovenia
Salt Lake City 2002,0,Switzerland,3,2,6,11,2002,Salt Lake City 2002 | Switzerland
Salt Lake City 2002,0,Great Britain,1,0,1,2,2002,Salt Lake City 2002 | Great Britain
Salt Lake City 2002,0,Republic of Korea,2,2,0,4,2002,Salt Lake City 2002 | Republic of Korea
Salt Lake City 2002,0,Netherlands,3,5,0,8,2002,Salt Lake City 2002 | Netherlands
Salt Lake City 2002,0,Finland,4,2,1,7,2002,Salt Lake City 2002 | Finland
Salt Lake City 2002,0,Germany,12,16,8,36,2002,Salt Lake City 2002 | Germany
Salt Lake City 2002,0,Austria,3,4,10,17,2002,Salt Lake City 2002 | Austria
Salt Lake City 2002,0,United States of America,10,13,11,34,2002,Salt Lake City 2002 | United States of America
Salt Lake City 2002,0,Sweden,0,2,5,7,2002,Salt Lake City 2002 | Sweden
Salt Lake City 2002,0,Australia,2,0,0,2,2002,Salt Lake City 2002 | Australia
Salt Lake City 2002,0,People's Republic of China,2,2,4,8,2002,Salt Lake City 2002 | People's Republic of China
Salt Lake City 2002,0,France,4,5,2,11,2002,Salt Lake City 2002 | France
Salt Lake City 2002,0,Poland,0,1,1,2,2002,Salt Lake City 2002 | Poland
Salt Lake City 2002,0,Bulgaria,0,1,2,3,2002,Salt Lake City 2002 | Bulgaria
Salt Lake City 2002,0,Japan,0,1,1,2,2002,Salt Lake City 2002 | Japan
Salt Lake City 2002,0,Croatia,3,1,0,4,2002,Salt Lake City 2002 | Croatia
Salt Lake City 2002,0,Italy,4,4,5,13,2002,Salt Lake City 2002 | Italy
Salt Lake City 2002,0,Belarus,0,0,1,1,2002,Salt Lake City 2002 | Belarus
Salt Lake City 2002,0,Norway,13,5,7,25,2002,Salt Lake City 2002 | Norway
Salt Lake City 2002,0,Estonia,1,1,1,3,2002,Salt Lake City 2002 | Estonia
Salt Lake City 2002,0,Canada,7,3,7,17,2002,Salt Lake City 2002 | Canada
Salt Lake City 2002,0,Czech Republic,1,2,0,3,2002,Salt Lake City 2002 | Czech Republic
Athens 2004,1,Lithuania,1,2,0,3,2004,Athens 2004 | Lithuania
Athens 2004,1,Great Britain,9,9,12,30,2004,Athens 2004 | Great Britain
Athens 2004,1,Indonesia,1,1,2,4,2004,Athens 2004 | Indonesia
Athens 2004,1,Serbia and Montenegro,0,2,0,2,2004,Athens 2004 | Serbia and Montenegro
Athens 2004,1,Finland,0,2,0,2,2004,Athens 2004 | Finland
Athens 2004,1,Croatia,1,2,2,5,2004,Athens 2004 | Croatia
Athens 2004,1,Austria,2,4,1,7,2004,Athens 2004 | Austria
Athens 2004,1,Slovenia,0,1,3,4,2004,Athens 2004 | Slovenia
Athens 2004,1,France,11,9,13,33,2004,Athens 2004 | France
Athens 2004,1,Denmark,2,1,5,8,2004,Athens 2004 | Denmark
Athens 2004,1,Morocco,2,1,0,3,2004,Athens 2004 | Morocco
Athens 2004,1,Dominican Republic,1,0,0,1,2004,Athens 2004 | Dominican Republic
Athens 2004,1,Cameroon,1,0,0,1,2004,Athens 2004 | Cameroon
Athens 2004,1,United Arab Emirates,1,0,0,1,2004,Athens 2004 | United Arab Emirates
Athens 2004,1,Chile,2,0,1,3,2004,Athens 2004 | Chile
Athens 2004,1,Spain,3,11,6,20,2004,Athens 2004 | Spain
Athens 2004,1,Italy,10,11,11,32,2004,Athens 2004 | Italy
Athens 2004,1,Mexico,0,3,1,4,2004,Athens 2004 | Mexico
Athens 2004,1,Latvia,0,4,0,4,2004,Athens 2004 | Latvia
Athens 2004,1,India,0,1,0,1,2004,Athens 2004 | India
Athens 2004,1,Sweden,4,2,1,7,2004,Athens 2004 | Sweden
Athens 2004,1,Thailand,3,1,4,8,2004,Athens 2004 | Thailand
Athens 2004,1,Republic of Korea,9,12,9,30,2004,Athens 2004 | Republic of Korea
Athens 2004,1,Paraguay,0,1,0,1,2004,Athens 2004 | Paraguay
Athens 2004,1,Japan,16,9,12,37,2004,Athens 2004 | Japan
Athens 2004,1,"Hong Kong, China",0,1,0,1,2004,"Athens 2004 | Hong Kong, China"
Athens 2004,1,Ethiopia,2,3,2,7,2004,Athens 2004 | Ethiopia
Athens 2004,1,Czech Republic,1,3,5,9,2004,Athens 2004 | Czech Republic
Athens 2004,1,Belgium,1,0,2,3,2004,Athens 2004 | Belgium
Athens 2004,1,Argentina,2,0,4,6,2004,Athens 2004 | Argentina
Athens 2004,1,Venezuela,0,0,2,2,2004,Athens 2004 | Venezuela
Athens 2004,1,Nigeria,0,0,2,2,2004,Athens 2004 | Nigeria
Athens 2004,1,Syrian Arab Republic,0,0,1,1,2004,Athens 2004 | Syrian Arab Republic
Athens 2004,1,Kenya,1,4,2,7,2004,Athens 2004 | Kenya
Athens 2004,1,Turkey,3,3,4,10,2004,Athens 2004 | Turkey
Athens 2004,1,Poland,3,2,5,10,2004,Athens 2004 | Poland
Athens 2004,1,Belarus,2,5,6,13,2004,Athens 2004 | Belarus
Athens 2004,1,South Africa,1,3,2,6,2004,Athens 2004 | South Africa
Athens 2004,1,Democratic People's Republic of Korea,0,4,1,5,2004,Athens 2004 | Democratic People's Republic of Korea
Athens 2004,1,Azerbaijan,1,0,4,5,2004,Athens 2004 | Azerbaijan
Athens 2004,1,Estonia,0,1,2,3,2004,Athens 2004 | Estonia
Athens 2004,1,Cuba,9,7,11,27,2004,Athens 2004 | Cuba
Athens 2004,1,Hungary,8,6,3,17,2004,Athens 2004 | Hungary
Athens 2004,1,Netherlands,4,9,9,22,2004,Athens 2004 | Netherlands
Athens 2004,1,New Zealand,3,2,0,5,2004,Athens 2004 | New Zealand
Athens 2004,1,Bulgaria,2,1,9,12,2004,Athens 2004 | Bulgaria
Athens 2004,1,Switzerland,1,1,3,5,2004,Athens 2004 | Switzerland
Athens 2004,1,Chinese Taipei,2,2,1,5,2004,Athens 2004 | Chinese Taipei
Athens 2004,1,Egypt,1,1,3,5,2004,Athens 2004 | Egypt
Athens 2004,1,Uzbekistan,2,1,2,5,2004,Athens 2004 | Uzbekistan
Athens 2004,1,Kazakhstan,1,4,3,8,2004,Athens 2004 | Kazakhstan
Athens 2004,1,Islamic Republic of Iran,2,2,2,6,2004,Athens 2004 | Islamic Republic of Iran
Athens 2004,1,Slovakia,2,2,2,6,2004,Athens 2004 | Slovakia
Athens 2004,1,Jamaica,2,1,2,5,2004,Athens 2004 | Jamaica
Athens 2004,1,Canada,3,6,3,12,2004,Athens 2004 | Canada
Athens 2004,1,Norway,5,0,1,6,2004,Athens 2004 | Norway
Athens 2004,1,United States of America,36,39,26,101,2004,Athens 2004 | United States of America
Athens 2004,1,Romania,8,5,6,19,2004,Athens 2004 | Romania
Athens 2004,1,Germany,13,16,20,49,2004,Athens 2004 | Germany
Athens 2004,1,Georgia,2,2,0,4,2004,Athens 2004 | Georgia
Athens 2004,1,Brazil,5,2,3,10,2004,Athens 2004 | Brazil
Athens 2004,1,Australia,17,16,17,50,2004,Athens 2004 | Australia
Athens 2004,1,Trinidad and Tobago,0,0,1,1,2004,Athens 2004 | Trinidad and Tobago
Athens 2004,1,Russian Federation,28,26,36,90,2004,Athens 2004 | Russian Federation
Athens 2004,1,Mongolia,0,0,1,1,2004,Athens 2004 | Mongolia
Athens 2004,1,Greece,6,6,4,16,2004,Athens 2004 | Greece
Athens 2004,1,Zimbabwe,1,1,1,3,2004,Athens 2004 | Zimbabwe
Athens 2004,1,Colombia,0,0,2,2,2004,Athens 2004 | Colombia
Athens 2004,1,Israel,1,0,1,2,2004,Athens 2004 | Israel
Athens 2004,1,Bahamas,1,0,1,2,2004,Athens 2004 | Bahamas
Athens 2004,1,Eritrea,0,0,1,1,2004,Athens 2004 | Eritrea
Athens 2004,1,Portugal,0,2,1,3,2004,Athens 2004 | Portugal
Athens 2004,1,People's Republic of China,32,17,14,63,2004,Athens 2004 | People's Republic of China
Athens 2004,1,Ukraine,8,5,9,22,2004,Athens 2004 | Ukraine
Beijing 2008,1,Poland,4,5,2,11,2008,Beijing 2008 | Poland
Beijing 2008,1,New Zealand,3,2,4,9,2008,Beijing 2008 | New Zealand
Beijing 2008,1,Tunisia,1,0,0,1,2008,Beijing 2008 | Tunisia
Beijing 2008,1,Japan,9,8,8,25,2008,Beijing 2008 | Japan
Beijing 2008,1,Norway,3,5,1,9,2008,Beijing 2008 | Norway
Beijing 2008,1,Jamaica,5,4,1,10,2008,Beijing 2008 | Jamaica
Beijing 2008,1,Romania,4,1,4,9,2008,Beijing 2008 | Romania
Beijing 2008,1,Cameroon,1,0,0,1,2008,Beijing 2008 | Cameroon
Beijing 2008,1,Republic of Korea,13,11,8,32,2008,Beijing 2008 | Republic of Korea
Beijing 2008,1,Kazakhstan,2,3,4,9,2008,Beijing 2008 | Kazakhstan
Beijing 2008,1,Italy,8,9,10,27,2008,Beijing 2008 | Italy
Beijing 2008,1,Hungary,3,5,2,10,2008,Beijing 2008 | Hungary
Beijing 2008,1,Egypt,0,0,2,2,2008,Beijing 2008 | Egypt
Beijing 2008,1,Ukraine,7,4,11,22,2008,Beijing 2008 | Ukraine
Beijing 2008,1,Panama,1,0,0,1,2008,Beijing 2008 | Panama
Beijing 2008,1,Cuba,3,10,17,30,2008,Beijing 2008 | Cuba
Beijing 2008,1,Brazil,3,4,10,17,2008,Beijing 2008 | Brazil
Beijing 2008,1,Kyrgyzstan,0,1,2,3,2008,Beijing 2008 | Kyrgyzstan
Beijing 2008,1,Croatia,0,2,3,5,2008,Beijing 2008 | Croatia
Beijing 2008,1,Lithuania,0,3,2,5,2008,Beijing 2008 | Lithuania
Beijing 2008,1,Sweden,0,4,1,5,2008,Beijing 2008 | Sweden
Beijing 2008,1,Sudan,0,1,0,1,2008,Beijing 2008 | Sudan
Beijing 2008,1,Serbia,0,1,2,3,2008,Beijing 2008 | Serbia
Beijing 2008,1,Austria,0,1,2,3,2008,Beijing 2008 | Austria
Beijing 2008,1,Ireland,0,1,2,3,2008,Beijing 2008 | Ireland
Beijing 2008,1,Nigeria,0,2,3,5,2008,Beijing 2008 | Nigeria
Beijing 2008,1,Iceland,0,1,0,1,2008,Beijing 2008 | Iceland
Beijing 2008,1,South Africa,0,1,0,1,2008,Beijing 2008 | South Africa
Beijing 2008,1,Bulgaria,1,1,3,5,2008,Beijing 2008 | Bulgaria
Beijing 2008,1,Malaysia,0,1,0,1,2008,Beijing 2008 | Malaysia
Beijing 2008,1,Slovenia,1,2,2,5,2008,Beijing 2008 | Slovenia
Beijing 2008,1,Uzbekistan,0,1,3,4,2008,Beijing 2008 | Uzbekistan
Beijing 2008,1,Belgium,2,0,0,2,2008,Beijing 2008 | Belgium
Beijing 2008,1,Indonesia,1,1,4,6,2008,Beijing 2008 | Indonesia
Beijing 2008,1,Ecuador,0,1,0,1,2008,Beijing 2008 | Ecuador
Beijing 2008,1,People's Republic of China,48,22,30,100,2008,Beijing 2008 | People's Republic of China
Beijing 2008,1,Samoa,0,1,0,1,2008,Beijing 2008 | Samoa
Beijing 2008,1,Chile,0,1,0,1,2008,Beijing 2008 | Chile
Beijing 2008,1,Chinese Taipei,1,1,2,4,2008,Beijing 2008 | Chinese Taipei
Beijing 2008,1,Finland,1,1,2,4,2008,Beijing 2008 | Finland
Beijing 2008,1,Latvia,1,1,1,3,2008,Beijing 2008 | Latvia
Beijing 2008,1,Mauritius,0,0,1,1,2008,Beijing 2008 | Mauritius
Beijing 2008,1,Zimbabwe,1,3,0,4,2008,Beijing 2008 | Zimbabwe
Beijing 2008,1,Togo,0,0,1,1,2008,Beijing 2008 | Togo
Beijing 2008,1,Republic of Moldova,0,0,1,1,2008,Beijing 2008 | Republic of Moldova
Beijing 2008,1,Mexico,2,0,2,4,2008,Beijing 2008 | Mexico
Beijing 2008,1,Venezuela,0,0,1,1,2008,Beijing 2008 | Venezuela
Beijing 2008,1,Israel,0,0,1,1,2008,Beijing 2008 | Israel
Beijing 2008,1,Afghanistan,0,0,1,1,2008,Beijing 2008 | Afghanistan
Beijing 2008,1,Vietnam,0,1,0,1,2008,Beijing 2008 | Vietnam
Beijing 2008,1,Mongolia,2,2,0,4,2008,Beijing 2008 | Mongolia
Beijing 2008,1,India,1,0,2,3,2008,Beijing 2008 | India
Beijing 2008,1,Armenia,0,1,4,5,2008,Beijing 2008 | Armenia
Beijing 2008,1,Colombia,0,2,1,3,2008,Beijing 2008 | Colombia
Beijing 2008,1,Greece,0,2,1,3,2008,Beijing 2008 | Greece
Beijing 2008,1,Azerbaijan,1,1,4,6,2008,Beijing 2008 | Azerbaijan
Beijing 2008,1,Estonia,1,1,0,2,2008,Beijing 2008 | Estonia
Beijing 2008,1,Turkey,1,1,3,5,2008,Beijing 2008 | Turkey
Beijing 2008,1,Singapore,0,1,0,1,2008,Beijing 2008 | Singapore
Beijing 2008,1,Czech Republic,3,3,1,7,2008,Beijing 2008 | Czech Republic
Beijing 2008,1,Denmark,2,2,3,7,2008,Beijing 2008 | Denmark
Beijing 2008,1,Switzerland,2,1,4,7,2008,Beijing 2008 | Switzerland
Beijing 2008,1,Germany,16,11,14,41,2008,Beijing 2008 | Germany
Beijing 2008,1,Ethiopia,4,2,1,7,2008,Beijing 2008 | Ethiopia
Beijing 2008,1,Portugal,1,1,0,2,2008,Beijing 2008 | Portugal
Beijing 2008,1,Tajikistan,0,1,1,2,2008,Beijing 2008 | Tajikistan
Beijing 2008,1,France,7,16,20,43,2008,Beijing 2008 | France
Beijing 2008,1,Australia,14,15,17,46,2008,Beijing 2008 | Australia
Beijing 2008,1,Algeria,0,1,1,2,2008,Beijing 2008 | Algeria
Beijing 2008,1,Spain,5,11,3,19,2008,Beijing 2008 | Spain
Beijing 2008,1,Georgia,3,2,2,7,2008,Beijing 2008 | Georgia
Beijing 2008,1,Great Britain,19,13,19,51,2008,Beijing 2008 | Great Britain
Beijing 2008,1,Kenya,6,4,6,16,2008,Beijing 2008 | Kenya
Beijing 2008,1,Slovakia,3,3,0,6,2008,Beijing 2008 | Slovakia
Beijing 2008,1,Netherlands,7,5,4,16,2008,Beijing 2008 | Netherlands
Beijing 2008,1,Trinidad and Tobago,1,1,0,2,2008,Beijing 2008 | Trinidad and Tobago
Beijing 2008,1,Dominican Republic,1,1,0,2,2008,Beijing 2008 | Dominican Republic
Beijing 2008,1,United States of America,36,39,37,112,2008,Beijing 2008 | United States of America
Beijing 2008,1,Belarus,3,4,7,14,2008,Beijing 2008 | Belarus
Beijing 2008,1,Morocco,0,1,1,2,2008,Beijing 2008 | Morocco
Beijing 2008,1,Argentina,2,0,4,6,2008,Beijing 2008 | Argentina
Beijing 2008,1,Russian Federation,24,13,23,60,2008,Beijing 2008 | Russian Federation
Beijing 2008,1,Canada,3,9,8,20,2008,Beijing 2008 | Canada
Beijing 2008,1,Thailand,2,2,2,6,2008,Beijing 2008 | Thailand
Beijing 2008,1,Islamic Republic of Iran,1,0,1,2,2008,Beijing 2008 | Islamic Republic of Iran
Beijing 2008,1,Bahamas,0,1,1,2,2008,Beijing 2008 | Bahamas
Beijing 2008,1,Democratic People's Republic of Korea,2,2,2,6,2008,Beijing 2008 | Democratic People's Republic of Korea
Vancouver 2010,0,Slovakia,1,1,1,3,2010,Vancouver 2010 | Slovakia
Vancouver 2010,0,Norway,9,8,6,23,2010,Vancouver 2010 | Norway
Vancouver 2010,0,Belarus,1,1,1,3,2010,Vancouver 2010 | Belarus
Vancouver 2010,0,People's Republic of China,5,2,4,11,2010,Vancouver 2010 | People's Republic of China
Vancouver 2010,0,Republic of Korea,6,6,2,14,2010,Vancouver 2010 | Republic of Korea
Vancouver 2010,0,Germany,10,13,7,30,2010,Vancouver 2010 | Germany
Vancouver 2010,0,Sweden,5,2,4,11,2010,Vancouver 2010 | Sweden
Vancouver 2010,0,United States of America,9,15,13,37,2010,Vancouver 2010 | United States of America
Vancouver 2010,0,Poland,1,3,2,6,2010,Vancouver 2010 | Poland
Vancouver 2010,0,Finland,0,1,4,5,2010,Vancouver 2010 | Finland
Vancouver 2010,0,Great Britain,1,0,0,1,2010,Vancouver 2010 | Great Britain
Vancouver 2010,0,Czech Republic,2,0,4,6,2010,Vancouver 2010 | Czech Republic
Vancouver 2010,0,Estonia,0,1,0,1,2010,Vancouver 2010 | Estonia
Vancouver 2010,0,Italy,1,1,3,5,2010,Vancouver 2010 | Italy
Vancouver 2010,0,Australia,2,1,0,3,2010,Vancouver 2010 | Australia
Vancouver 2010,0,Switzerland,6,0,3,9,2010,Vancouver 2010 | Switzerland
Vancouver 2010,0,Netherlands,4,1,3,8,2010,Vancouver 2010 | Netherlands
Vancouver 2010,0,Austria,4,6,6,16,2010,Vancouver 2010 | Austria
Vancouver 2010,0,Kazakhstan,0,1,0,1,2010,Vancouver 2010 | Kazakhstan
Vancouver 2010,0,Russian Federation,3,5,7,15,2010,Vancouver 2010 | Russian Federation
Vancouver 2010,0,Latvia,0,2,0,2,2010,Vancouver 2010 | Latvia
Vancouver 2010,0,Croatia,0,2,1,3,2010,Vancouver 2010 | Croatia
Vancouver 2010,0,Slovenia,0,2,1,3,2010,Vancouver 2010 | Slovenia
Vancouver 2010,0,France,2,3,6,11,2010,Vancouver 2010 | France
Vancouver 2010,0,Japan,0,3,2,5,2010,Vancouver 2010 | Japan
Vancouver 2010,0,Canada,14,7,5,26,2010,Vancouver 2010 | Canada
London 2012,1,Cyprus,0,1,0,1,2012,London 2012 | Cyprus
London 2012,1,Islamic Republic of Iran,6,6,1,13,2012,London 2012 | Islamic Republic of Iran
London 2012,1,Montenegro,0,1,0,1,2012,London 2012 | Montenegro
London 2012,1,Hungary,8,4,6,18,2012,London 2012 | Hungary
London 2012,1,Spain,4,10,4,18,2012,London 2012 | Spain
London 2012,1,Netherlands,6,6,8,20,2012,London 2012 | Netherlands
London 2012,1,Guatemala,0,1,0,1,2012,London 2012 | Guatemala
London 2012,1,Portugal,0,1,0,1,2012,London 2012 | Portugal
London 2012,1,Kenya,2,4,6,12,2012,London 2012 | Kenya
London 2012,1,Canada,2,5,11,18,2012,London 2012 | Canada
London 2012,1,Jamaica,4,5,3,12,2012,London 2012 | Jamaica
London 2012,1,Brazil,3,5,9,17,2012,London 2012 | Brazil
London 2012,1,Cuba,5,3,7,15,2012,London 2012 | Cuba
London 2012,1,New Zealand,6,2,5,13,2012,London 2012 | New Zealand
London 2012,1,Ukraine,5,4,10,19,2012,London 2012 | Ukraine
London 2012,1,Bahrain,1,0,0,1,2012,London 2012 | Bahrain
London 2012,1,Gabon,0,1,0,1,2012,London 2012 | Gabon
London 2012,1,Germany,11,20,13,44,2012,London 2012 | Germany
London 2012,1,Trinidad and Tobago,1,1,2,4,2012,London 2012 | Trinidad and Tobago
London 2012,1,Dominican Republic,1,1,0,2,2012,London 2012 | Dominican Republic
London 2012,1,Russian Federation,20,19,28,67,2012,London 2012 | Russian Federation
London 2012,1,Great Britain,29,17,19,65,2012,London 2012 | Great Britain
London 2012,1,Croatia,3,1,2,6,2012,London 2012 | Croatia
London 2012,1,Chinese Taipei,1,0,1,2,2012,London 2012 | Chinese Taipei
London 2012,1,Latvia,1,0,1,2,2012,London 2012 | Latvia
London 2012,1,Democratic People's Republic of Korea,4,0,2,6,2012,London 2012 | Democratic People's Republic of Korea
London 2012,1,Algeria,1,0,0,1,2012,London 2012 | Algeria
London 2012,1,People's Republic of China,38,31,22,91,2012,London 2012 | People's Republic of China
London 2012,1,Tunisia,2,0,1,3,2012,London 2012 | Tunisia
London 2012,1,South Africa,4,1,1,6,2012,London 2012 | South Africa
London 2012,1,Argentina,1,1,2,4,2012,London 2012 | Argentina
London 2012,1,Egypt,0,3,1,4,2012,London 2012 | Egypt
London 2012,1,Thailand,0,2,2,4,2012,London 2012 | Thailand
London 2012,1,Japan,7,14,17,38,2012,London 2012 | Japan
London 2012,1,Ethiopia,3,2,2,7,2012,London 2012 | Ethiopia
London 2012,1,Georgia,1,2,3,6,2012,London 2012 | Georgia
London 2012,1,Botswana,0,1,0,1,2012,London 2012 | Botswana
London 2012,1,Slovenia,1,1,2,4,2012,London 2012 | Slovenia
London 2012,1,India,0,2,4,6,2012,London 2012 | India
London 2012,1,Tajikistan,0,0,1,1,2012,London 2012 | Tajikistan
London 2012,1,Kuwait,0,0,1,1,2012,London 2012 | Kuwait
London 2012,1,Saudi Arabia,0,0,1,1,2012,London 2012 | Saudi Arabia
London 2012,1,Morocco,0,0,1,1,2012,London 2012 | Morocco
London 2012,1,Afghanistan,0,0,1,1,2012,London 2012 | Afghanistan
London 2012,1,"Hong Kong, China",0,0,1,1,2012,"London 2012 | Hong Kong, China"
London 2012,1,Cameroon,0,0,1,1,2012,London 2012 | Cameroon
London 2012,1,Turkey,1,1,1,3,2012,London 2012 | Turkey
London 2012,1,United States of America,46,28,30,104,2012,London 2012 | United States of America
London 2012,1,Norway,2,1,1,4,2012,London 2012 | Norway
London 2012,1,Switzerland,2,2,0,4,2012,London 2012 | Switzerland
London 2012,1,Bulgaria,0,2,1,3,2012,London 2012 | Bulgaria
London 2012,1,Finland,0,2,1,3,2012,London 2012 | Finland
London 2012,1,Indonesia,0,2,1,3,2012,London 2012 | Indonesia
London 2012,1,Mongolia,0,2,3,5,2012,London 2012 | Mongolia
London 2012,1,Belgium,0,1,2,3,2012,London 2012 | Belgium
London 2012,1,Lithuania,2,0,3,5,2012,London 2012 | Lithuania
London 2012,1,Ireland,1,1,4,6,2012,London 2012 | Ireland
London 2012,1,Mexico,1,3,4,8,2012,London 2012 | Mexico
London 2012,1,Serbia,1,1,2,4,2012,London 2012 | Serbia
London 2012,1,Republic of Korea,13,9,8,30,2012,London 2012 | Republic of Korea
London 2012,1,Singapore,0,0,2,2,2012,London 2012 | Singapore
London 2012,1,Uzbekistan,0,0,2,2,2012,London 2012 | Uzbekistan
London 2012,1,Greece,0,0,2,2,2012,London 2012 | Greece
London 2012,1,Azerbaijan,2,2,6,10,2012,London 2012 | Azerbaijan
London 2012,1,Slovakia,0,1,3,4,2012,London 2012 | Slovakia
London 2012,1,Belarus,2,5,3,10,2012,London 2012 | Belarus
London 2012,1,Puerto Rico,0,1,1,2,2012,London 2012 | Puerto Rico
London 2012,1,Kazakhstan,3,1,7,11,2012,London 2012 | Kazakhstan
London 2012,1,Poland,3,1,7,11,2012,London 2012 | Poland
London 2012,1,Czech Republic,4,3,4,11,2012,London 2012 | Czech Republic
London 2012,1,Sweden,1,4,3,8,2012,London 2012 | Sweden
London 2012,1,Qatar,0,0,2,2,2012,London 2012 | Qatar
London 2012,1,Italy,8,9,11,28,2012,London 2012 | Italy
London 2012,1,Denmark,2,4,3,9,2012,London 2012 | Denmark
London 2012,1,Venezuela,1,0,0,1,2012,London 2012 | Venezuela
London 2012,1,Colombia,1,3,4,8,2012,London 2012 | Colombia
London 2012,1,Australia,8,15,12,35,2012,London 2012 | Australia
London 2012,1,France,11,11,13,35,2012,London 2012 | France
London 2012,1,Uganda,1,0,0,1,2012,London 2012 | Uganda
London 2012,1,Bahamas,1,0,0,1,2012,London 2012 | Bahamas
London 2012,1,Romania,2,5,2,9,2012,London 2012 | Romania
London 2012,1,Estonia,0,1,1,2,2012,London 2012 | Estonia
London 2012,1,Armenia,0,1,1,2,2012,London 2012 | Armenia
London 2012,1,Malaysia,0,1,1,2,2012,London 2012 | Malaysia
London 2012,1,Grenada,1,0,0,1,2012,London 2012 | Grenada
Sochi 2014,0,Latvia,1,1,3,5,2014,Sochi 2014 | Latvia
Sochi 2014,0,Great Britain,1,1,3,5,2014,Sochi 2014 | Great Britain
Sochi 2014,0,Italy,0,2,6,8,2014,Sochi 2014 | Italy
Sochi 2014,0,Switzerland,7,2,2,11,2014,Sochi 2014 | Switzerland
Sochi 2014,0,Norway,11,5,10,26,2014,Sochi 2014 | Norway
Sochi 2014,0,Finland,1,3,1,5,2014,Sochi 2014 | Finland
Sochi 2014,0,Canada,10,10,5,25,2014,Sochi 2014 | Canada
Sochi 2014,0,Netherlands,8,7,9,24,2014,Sochi 2014 | Netherlands
Sochi 2014,0,Kazakhstan,0,0,1,1,2014,Sochi 2014 | Kazakhstan
Sochi 2014,0,Australia,0,2,1,3,2014,Sochi 2014 | Australia
Sochi 2014,0,Croatia,0,1,0,1,2014,Sochi 2014 | Croatia
Sochi 2014,0,Slovakia,1,0,0,1,2014,Sochi 2014 | Slovakia
Sochi 2014,0,United States of America,9,9,10,28,2014,Sochi 2014 | United States of America
Sochi 2014,0,Sweden,2,7,6,15,2014,Sochi 2014 | Sweden
Sochi 2014,0,France,4,4,7,15,2014,Sochi 2014 | France
Sochi 2014,0,Germany,8,6,5,19,2014,Sochi 2014 | Germany
Sochi 2014,0,Belarus,5,0,1,6,2014,Sochi 2014 | Belarus
Sochi 2014,0,Japan,1,4,3,8,2014,Sochi 2014 | Japan
Sochi 2014,0,Poland,4,1,1,6,2014,Sochi 2014 | Poland
Sochi 2014,0,Slovenia,2,2,4,8,2014,Sochi 2014 | Slovenia
Sochi 2014,0,People's Republic of China,3,4,2,9,2014,Sochi 2014 | People's Republic of China
Sochi 2014,0,Czech Republic,2,4,2,8,2014,Sochi 2014 | Czech Republic
Sochi 2014,0,Republic of Korea,3,3,2,8,2014,Sochi 2014 | Republic of Korea
Sochi 2014,0,Austria,4,8,5,17,2014,Sochi 2014 | Austria
Sochi 2014,0,Russian Federation,11,9,9,29,2014,Sochi 2014 | Russian Federation
Sochi 2014,0,Ukraine,1,0,1,2,2014,Sochi 2014 | Ukraine
Rio 2016,1,Dominican Republic,0,0,1,1,2016,Rio 2016 | Dominican Republic
Rio 2016,1,Morocco,0,0,1,1,2016,Rio 2016 | Morocco
Rio 2016,1,Finland,0,0,1,1,2016,Rio 2016 | Finland
Rio 2016,1,Portugal,0,0,1,1,2016,Rio 2016 | Portugal
Rio 2016,1,Austria,0,0,1,1,2016,Rio 2016 | Austria
Rio 2016,1,Estonia,0,0,1,1,2016,Rio 2016 | Estonia
Rio 2016,1,Nigeria,0,0,1,1,2016,Rio 2016 | Nigeria
Rio 2016,1,United Arab Emirates,0,0,1,1,2016,Rio 2016 | United Arab Emirates
Rio 2016,1,Trinidad and Tobago,0,0,1,1,2016,Rio 2016 | Trinidad and Tobago
Rio 2016,1,Grenada,0,1,0,1,2016,Rio 2016 | Grenada
Rio 2016,1,Philippines,0,1,0,1,2016,Rio 2016 | Philippines
Rio 2016,1,Qatar,0,1,0,1,2016,Rio 2016 | Qatar
Rio 2016,1,Great Britain,27,23,17,67,2016,Rio 2016 | Great Britain
Rio 2016,1,Burundi,0,1,0,1,2016,Rio 2016 | Burundi
Rio 2016,1,Russian Federation,19,17,20,56,2016,Rio 2016 | Russian Federation
Rio 2016,1,Brazil,7,6,6,19,2016,Rio 2016 | Brazil
Rio 2016,1,Germany,17,10,15,42,2016,Rio 2016 | Germany
Rio 2016,1,France,10,18,14,42,2016,Rio 2016 | France
Rio 2016,1,Netherlands,8,7,4,19,2016,Rio 2016 | Netherlands
Rio 2016,1,Japan,12,8,21,41,2016,Rio 2016 | Japan
Rio 2016,1,Republic of Korea,9,3,9,21,2016,Rio 2016 | Republic of Korea
Rio 2016,1,Australia,8,11,10,29,2016,Rio 2016 | Australia
Rio 2016,1,Italy,8,12,8,28,2016,Rio 2016 | Italy
Rio 2016,1,Canada,4,3,15,22,2016,Rio 2016 | Canada
Rio 2016,1,Niger,0,1,0,1,2016,Rio 2016 | Niger
Rio 2016,1,Lithuania,0,1,3,4,2016,Rio 2016 | Lithuania
Rio 2016,1,People's Republic of China,26,18,26,70,2016,Rio 2016 | People's Republic of China
Rio 2016,1,New Zealand,4,9,5,18,2016,Rio 2016 | New Zealand
Rio 2016,1,Romania,1,1,2,4,2016,Rio 2016 | Romania
Rio 2016,1,Indonesia,1,2,0,3,2016,Rio 2016 | Indonesia
Rio 2016,1,Turkey,1,3,4,8,2016,Rio 2016 | Turkey
Rio 2016,1,Mongolia,0,1,1,2,2016,Rio 2016 | Mongolia
Rio 2016,1,India,0,1,1,2,2016,Rio 2016 | India
Rio 2016,1,Kosovo,1,0,0,1,2016,Rio 2016 | Kosovo
Rio 2016,1,Singapore,1,0,0,1,2016,Rio 2016 | Singapore
Rio 2016,1,Fiji,1,0,0,1,2016,Rio 2016 | Fiji
Rio 2016,1,Tajikistan,1,0,0,1,2016,Rio 2016 | Tajikistan
Rio 2016,1,Jordan,1,0,0,1,2016,Rio 2016 | Jordan
Rio 2016,1,Puerto Rico,1,0,0,1,2016,Rio 2016 | Puerto Rico
Rio 2016,1,Jamaica,6,3,2,11,2016,Rio 2016 | Jamaica
Rio 2016,1,Cuba,5,2,4,11,2016,Rio 2016 | Cuba
Rio 2016,1,Ethiopia,1,2,5,8,2016,Rio 2016 | Ethiopia
Rio 2016,1,Argentina,3,1,0,4,2016,Rio 2016 | Argentina
Rio 2016,1,Sweden,2,6,3,11,2016,Rio 2016 | Sweden
Rio 2016,1,Ukraine,2,5,4,11,2016,Rio 2016 | Ukraine
Rio 2016,1,Poland,2,3,6,11,2016,Rio 2016 | Poland
Rio 2016,1,Croatia,5,3,2,10,2016,Rio 2016 | Croatia
Rio 2016,1,Slovakia,2,2,0,4,2016,Rio 2016 | Slovakia
Rio 2016,1,Serbia,2,4,2,8,2016,Rio 2016 | Serbia
Rio 2016,1,South Africa,2,6,2,10,2016,Rio 2016 | South Africa
Rio 2016,1,Czech Republic,1,2,7,10,2016,Rio 2016 | Czech Republic
Rio 2016,1,Slovenia,1,2,1,4,2016,Rio 2016 | Slovenia
Rio 2016,1,Islamic Republic of Iran,3,1,4,8,2016,Rio 2016 | Islamic Republic of Iran
Rio 2016,1,Armenia,1,3,0,4,2016,Rio 2016 | Armenia
Rio 2016,1,Colombia,3,2,3,8,2016,Rio 2016 | Colombia
Rio 2016,1,Belarus,1,4,4,9,2016,Rio 2016 | Belarus
Rio 2016,1,Chinese Taipei,1,0,2,3,2016,Rio 2016 | Chinese Taipei
Rio 2016,1,Switzerland,3,2,2,7,2016,Rio 2016 | Switzerland
Rio 2016,1,Venezuela,0,2,1,3,2016,Rio 2016 | Venezuela
Rio 2016,1,Egypt,0,0,3,3,2016,Rio 2016 | Egypt
Rio 2016,1,Kazakhstan,3,5,10,18,2016,Rio 2016 | Kazakhstan
Rio 2016,1,Azerbaijan,1,7,10,18,2016,Rio 2016 | Azerbaijan
Rio 2016,1,Spain,7,4,6,17,2016,Rio 2016 | Spain
Rio 2016,1,Bahrain,1,1,0,2,2016,Rio 2016 | Bahrain
Rio 2016,1,Vietnam,1,1,0,2,2016,Rio 2016 | Vietnam
Rio 2016,1,Thailand,2,2,2,6,2016,Rio 2016 | Thailand
Rio 2016,1,Hungary,8,3,4,15,2016,Rio 2016 | Hungary
Rio 2016,1,Belgium,2,2,2,6,2016,Rio 2016 | Belgium
Rio 2016,1,Greece,3,1,2,6,2016,Rio 2016 | Greece
Rio 2016,1,Independent Olympic Athletes,1,0,1,2,2016,Rio 2016 | Independent Olympic Athletes
Rio 2016,1,Bahamas,1,0,1,2,2016,Rio 2016 | Bahamas
Rio 2016,1,Côte d'Ivoire,1,0,1,2,2016,Rio 2016 | Côte d'Ivoire
Rio 2016,1,Tunisia,0,0,3,3,2016,Rio 2016 | Tunisia
Rio 2016,1,Bulgaria,0,1,2,3,2016,Rio 2016 | Bulgaria
Rio 2016,1,Israel,0,0,2,2,2016,Rio 2016 | Israel
Rio 2016,1,Kenya,6,6,1,13,2016,Rio 2016 | Kenya
Rio 2016,1,Uzbekistan,4,2,7,13,2016,Rio 2016 | Uzbekistan
Rio 2016,1,Denmark,2,6,7,15,2016,Rio 2016 | Denmark
Rio 2016,1,Malaysia,0,4,1,5,2016,Rio 2016 | Malaysia
Rio 2016,1,Georgia,2,1,4,7,2016,Rio 2016 | Georgia
Rio 2016,1,Mexico,0,3,2,5,2016,Rio 2016 | Mexico
Rio 2016,1,Ireland,0,2,0,2,2016,Rio 2016 | Ireland
Rio 2016,1,Norway,0,0,4,4,2016,Rio 2016 | Norway
Rio 2016,1,United States of America,46,37,38,121,2016,Rio 2016 | United States of America
Rio 2016,1,Algeria,0,2,0,2,2016,Rio 2016 | Algeria
Rio 2016,1,Democratic People's Republic of Korea,2,3,2,7,2016,Rio 2016 | Democratic People's Republic of Korea
PyeongChang 2018,0,People's Republic of China,1,6,2,9,2018,PyeongChang 2018 | People's Republic of China
PyeongChang 2018,0,Great Britain,1,0,4,5,2018,PyeongChang 2018 | Great Britain
PyeongChang 2018,0,Czech Republic,2,2,3,7,2018,PyeongChang 2018 | Czech Republic
PyeongChang 2018,0,Slovenia,0,1,1,2,2018,PyeongChang 2018 | Slovenia
PyeongChang 2018,0,Poland,1,0,1,2,2018,PyeongChang 2018 | Poland
PyeongChang 2018,0,Norway,14,14,11,39,2018,PyeongChang 2018 | Norway
PyeongChang 2018,0,Germany,14,10,7,31,2018,PyeongChang 2018 | Germany
PyeongChang 2018,0,Australia,0,2,1,3,2018,PyeongChang 2018 | Australia
PyeongChang 2018,0,Finland,1,1,4,6,2018,PyeongChang 2018 | Finland
PyeongChang 2018,0,Canada,11,8,10,29,2018,PyeongChang 2018 | Canada
PyeongChang 2018,0,France,5,4,6,15,2018,PyeongChang 2018 | France
PyeongChang 2018,0,Switzerland,5,6,4,15,2018,PyeongChang 2018 | Switzerland
PyeongChang 2018,0,Austria,5,3,6,14,2018,PyeongChang 2018 | Austria
PyeongChang 2018,0,Liechtenstein,0,0,1,1,2018,PyeongChang 2018 | Liechtenstein
PyeongChang 2018,0,New Zealand,0,0,2,2,2018,PyeongChang 2018 | New Zealand
PyeongChang 2018,0,Japan,4,5,4,13,2018,PyeongChang 2018 | Japan
PyeongChang 2018,0,Belarus,2,1,0,3,2018,PyeongChang 2018 | Belarus
PyeongChang 2018,0,Netherlands,8,6,6,20,2018,PyeongChang 2018 | Netherlands
PyeongChang 2018,0,Kazakhstan,0,0,1,1,2018,PyeongChang 2018 | Kazakhstan
PyeongChang 2018,0,Sweden,7,6,1,14,2018,PyeongChang 2018 | Sweden
PyeongChang 2018,0,Hungary,1,0,0,1,2018,PyeongChang 2018 | Hungary
PyeongChang 2018,0,United States of America,9,8,6,23,2018,PyeongChang 2018 | United States of America
PyeongChang 2018,0,Ukraine,1,0,0,1,2018,PyeongChang 2018 | Ukraine
PyeongChang 2018,0,Latvia,0,0,1,1,2018,PyeongChang 2018 | Latvia
PyeongChang 2018,0,Republic of Korea,5,8,4,17,2018,PyeongChang 2018 | Republic of Korea
PyeongChang 2018,0,Spain,0,0,2,2,2018,PyeongChang 2018 | Spain
PyeongChang 2018,0,Olympic Athletes from Russia,2,6,9,17,2018,PyeongChang 2018 | Olympic Athletes from Russia
PyeongChang 2018,0,Italy,3,2,5,10,2018,PyeongChang 2018 | Italy
PyeongChang 2018,0,Belgium,0,1,0,1,2018,PyeongChang 2018 | Belgium
PyeongChang 2018,0,Slovakia,1,2,0,3,2018,PyeongChang 2018 | Slovakia
Tokyo 2020,1,Syrian Arab Republic,0,0,1,1,2021,Tokyo 2020 | Syrian Arab Republic
Tokyo 2020,1,Slovenia,3,1,1,5,2021,Tokyo 2020 | Slovenia
Tokyo 2020,1,Bahamas,2,0,0,2,2021,Tokyo 2020 | Bahamas
Tokyo 2020,1,Ghana,0,0,1,1,2021,Tokyo 2020 | Ghana
Tokyo 2020,1,Kosovo,2,0,0,2,2021,Tokyo 2020 | Kosovo
Tokyo 2020,1,Grenada,0,0,1,1,2021,Tokyo 2020 | Grenada
Tokyo 2020,1,Kuwait,0,0,1,1,2021,Tokyo 2020 | Kuwait
Tokyo 2020,1,Burkina Faso,0,0,1,1,2021,Tokyo 2020 | Burkina Faso
Tokyo 2020,1,Republic of Moldova,0,0,1,1,2021,Tokyo 2020 | Republic of Moldova
Tokyo 2020,1,Uzbekistan,3,0,2,5,2021,Tokyo 2020 | Uzbekistan
Tokyo 2020,1,Botswana,0,0,1,1,2021,Tokyo 2020 | Botswana
Tokyo 2020,1,San Marino,0,1,2,3,2021,Tokyo 2020 | San Marino
Tokyo 2020,1,Argentina,0,1,2,3,2021,Tokyo 2020 | Argentina
Tokyo 2020,1,Mexico,0,0,4,4,2021,Tokyo 2020 | Mexico
Tokyo 2020,1,Colombia,0,4,1,5,2021,Tokyo 2020 | Colombia
Tokyo 2020,1,Israel,2,0,2,4,2021,Tokyo 2020 | Israel
Tokyo 2020,1,Ireland,2,0,2,4,2021,Tokyo 2020 | Ireland
Tokyo 2020,1,Egypt,1,1,4,6,2021,Tokyo 2020 | Egypt
Tokyo 2020,1,Romania,1,3,0,4,2021,Tokyo 2020 | Romania
Tokyo 2020,1,Uganda,2,1,1,4,2021,Tokyo 2020 | Uganda
Tokyo 2020,1,Greece,2,1,1,4,2021,Tokyo 2020 | Greece
Tokyo 2020,1,Philippines,1,2,1,4,2021,Tokyo 2020 | Philippines
Tokyo 2020,1,Slovakia,1,2,1,4,2021,Tokyo 2020 | Slovakia
Tokyo 2020,1,Indonesia,1,1,3,5,2021,Tokyo 2020 | Indonesia
Tokyo 2020,1,South Africa,1,2,0,3,2021,Tokyo 2020 | South Africa
Tokyo 2020,1,Portugal,1,1,2,4,2021,Tokyo 2020 | Portugal
Tokyo 2020,1,Ethiopia,1,1,2,4,2021,Tokyo 2020 | Ethiopia
Tokyo 2020,1,Qatar,2,0,1,3,2021,Tokyo 2020 | Qatar
Tokyo 2020,1,Armenia,0,2,2,4,2021,Tokyo 2020 | Armenia
Tokyo 2020,1,Kyrgyzstan,0,2,1,3,2021,Tokyo 2020 | Kyrgyzstan
Tokyo 2020,1,Dominican Republic,0,3,2,5,2021,Tokyo 2020 | Dominican Republic
Tokyo 2020,1,Ecuador,2,1,0,3,2021,Tokyo 2020 | Ecuador
Tokyo 2020,1,Côte d'Ivoire,0,0,1,1,2021,Tokyo 2020 | Côte d'Ivoire
Tokyo 2020,1,ROC,20,28,23,71,2021,Tokyo 2020 | ROC
Tokyo 2020,1,Venezuela,1,3,0,4,2021,Tokyo 2020 | Venezuela
Tokyo 2020,1,Belgium,3,1,3,7,2021,Tokyo 2020 | Belgium
Tokyo 2020,1,Tunisia,1,1,0,2,2021,Tokyo 2020 | Tunisia
Tokyo 2020,1,Mongolia,0,1,3,4,2021,Tokyo 2020 | Mongolia
Tokyo 2020,1,Kenya,4,4,2,10,2021,Tokyo 2020 | Kenya
Tokyo 2020,1,Denmark,3,4,4,11,2021,Tokyo 2020 | Denmark
Tokyo 2020,1,Czech Republic,4,4,3,11,2021,Tokyo 2020 | Czech Republic
Tokyo 2020,1,Canada,7,6,11,24,2021,Tokyo 2020 | Canada
Tokyo 2020,1,Puerto Rico,1,0,0,1,2021,Tokyo 2020 | Puerto Rico
Tokyo 2020,1,Bermuda,1,0,0,1,2021,Tokyo 2020 | Bermuda
Tokyo 2020,1,Morocco,1,0,0,1,2021,Tokyo 2020 | Morocco
Tokyo 2020,1,Chinese Taipei,2,4,6,12,2021,Tokyo 2020 | Chinese Taipei
Tokyo 2020,1,Turkey,2,2,9,13,2021,Tokyo 2020 | Turkey
Tokyo 2020,1,Switzerland,3,4,6,13,2021,Tokyo 2020 | Switzerland
Tokyo 2020,1,Brazil,7,6,8,21,2021,Tokyo 2020 | Brazil
Tokyo 2020,1,New Zealand,7,6,7,20,2021,Tokyo 2020 | New Zealand
Tokyo 2020,1,Hungary,6,7,7,20,2021,Tokyo 2020 | Hungary
Tokyo 2020,1,Republic of Korea,6,4,10,20,2021,Tokyo 2020 | Republic of Korea
Tokyo 2020,1,Poland,4,5,5,14,2021,Tokyo 2020 | Poland
Tokyo 2020,1,People's Republic of China,38,32,18,88,2021,Tokyo 2020 | People's Republic of China
Tokyo 2020,1,Cuba,7,3,5,15,2021,Tokyo 2020 | Cuba
Tokyo 2020,1,Saudi Arabia,0,1,0,1,2021,Tokyo 2020 | Saudi Arabia
Tokyo 2020,1,North Macedonia,0,1,0,1,2021,Tokyo 2020 | North Macedonia
Tokyo 2020,1,Lithuania,0,1,0,1,2021,Tokyo 2020 | Lithuania
Tokyo 2020,1,Turkmenistan,0,1,0,1,2021,Tokyo 2020 | Turkmenistan
Tokyo 2020,1,Namibia,0,1,0,1,2021,Tokyo 2020 | Namibia
Tokyo 2020,1,Bahrain,0,1,0,1,2021,Tokyo 2020 | Bahrain
Tokyo 2020,1,Spain,3,8,6,17,2021,Tokyo 2020 | Spain
Tokyo 2020,1,Sweden,3,6,0,9,2021,Tokyo 2020 | Sweden
Tokyo 2020,1,"Hong Kong, China",1,2,3,6,2021,"Tokyo 2020 | Hong Kong, China"
Tokyo 2020,1,Serbia,3,1,5,9,2021,Tokyo 2020 | Serbia
Tokyo 2020,1,Norway,4,2,2,8,2021,Tokyo 2020 | Norway
Tokyo 2020,1,United States of America,39,41,33,113,2021,Tokyo 2020 | United States of America
Tokyo 2020,1,Great Britain,22,21,22,65,2021,Tokyo 2020 | Great Britain
Tokyo 2020,1,Bulgaria,3,1,2,6,2021,Tokyo 2020 | Bulgaria
Tokyo 2020,1,Japan,27,14,17,58,2021,Tokyo 2020 | Japan
Tokyo 2020,1,Estonia,1,0,1,2,2021,Tokyo 2020 | Estonia
Tokyo 2020,1,Fiji,1,0,1,2,2021,Tokyo 2020 | Fiji
Tokyo 2020,1,Thailand,1,0,1,2,2021,Tokyo 2020 | Thailand
Tokyo 2020,1,Latvia,1,0,1,2,2021,Tokyo 2020 | Latvia
Tokyo 2020,1,Azerbaijan,0,3,4,7,2021,Tokyo 2020 | Azerbaijan
Tokyo 2020,1,Australia,17,7,22,46,2021,Tokyo 2020 | Australia
Tokyo 2020,1,Austria,1,1,5,7,2021,Tokyo 2020 | Austria
Tokyo 2020,1,India,1,2,4,7,2021,Tokyo 2020 | India
Tokyo 2020,1,Belarus,1,3,3,7,2021,Tokyo 2020 | Belarus
Tokyo 2020,1,Italy,10,10,20,40,2021,Tokyo 2020 | Italy
Tokyo 2020,1,Ukraine,1,6,12,19,2021,Tokyo 2020 | Ukraine
Tokyo 2020,1,Islamic Republic of Iran,3,2,2,7,2021,Tokyo 2020 | Islamic Republic of Iran
Tokyo 2020,1,Kazakhstan,0,0,8,8,2021,Tokyo 2020 | Kazakhstan
Tokyo 2020,1,Germany,10,11,16,37,2021,Tokyo 2020 | Germany
Tokyo 2020,1,Netherlands,10,12,14,36,2021,Tokyo 2020 | Netherlands
Tokyo 2020,1,Nigeria,0,1,1,2,2021,Tokyo 2020 | Nigeria
Tokyo 2020,1,Malaysia,0,1,1,2,2021,Tokyo 2020 | Malaysia
Tokyo 2020,1,Jordan,0,1,1,2,2021,Tokyo 2020 | Jordan
Tokyo 2020,1,France,10,12,11,33,2021,Tokyo 2020 | France
Tokyo 2020,1,Georgia,2,5,1,8,2021,Tokyo 2020 | Georgia
Tokyo 2020,1,Croatia,3,3,2,8,2021,Tokyo 2020 | Croatia
Tokyo 2020,1,Finland,0,0,2,2,2021,Tokyo 2020 | Finland
Tokyo 2020,1,Jamaica,4,1,4,9,2021,Tokyo 2020 | Jamaica
